PokerStars Hand #201496729627: Tournament #2632284264, 17000+3000 Hold'em No Limit - Level I (10/20) - 2019/06/17 21:38:39 ET
Table '2632284264 3' 9-max Seat #1 is the button
Seat 1: O Aprendi105 (1500 in chips) 
Seat 2: HSagerbaf (1500 in chips) 
Seat 3: Taargeett (1500 in chips) 
Seat 4: Coolie_1963 (1500 in chips) 
Seat 5: DPALMA2017 (1500 in chips) 
Seat 6: PhxdB420 (1500 in chips) 
Seat 7: IKE67701 (1500 in chips) is sitting out
Seat 8: concorddeadi (1500 in chips) 
Seat 9: chrisg1987 (1500 in chips) 
HSagerbaf: posts small blind 10
Taargeett: posts big blind 20
*** HOLE CARDS ***
Dealt to Taargeett [As 9d]
Coolie_1963: folds 
DPALMA2017: folds 
PhxdB420: raises 40 to 60
IKE67701: folds 
concorddeadi: folds 
chrisg1987: calls 60
O Aprendi105: calls 60
HSagerbaf: calls 50
Taargeett: calls 40
*** FLOP *** [5d 6h Qd]
HSagerbaf: bets 60
Taargeett: folds 
PhxdB420: calls 60
chrisg1987: folds 
O Aprendi105: calls 60
*** TURN *** [5d 6h Qd] [4s]
HSagerbaf: bets 80
PhxdB420: folds 
O Aprendi105: calls 80
*** RIVER *** [5d 6h Qd 4s] [Kc]
HSagerbaf: bets 480
O Aprendi105: folds 
Uncalled bet (480) returned to HSagerbaf
HSagerbaf collected 640 from pot
HSagerbaf: doesn't show hand 
*** SUMMARY ***
Total pot 640 | Rake 0 
Board [5d 6h Qd 4s Kc]
Seat 1: O Aprendi105 (button) folded on the River
Seat 2: HSagerbaf (small blind) collected (640)
Seat 3: Taargeett (big blind) folded on the Flop
Seat 4: Coolie_1963 folded before Flop (didn't bet)
Seat 5: DPALMA2017 folded before Flop (didn't bet)
Seat 6: PhxdB420 folded on the Turn
Seat 7: IKE67701 folded before Flop (didn't bet)
Seat 8: concorddeadi folded before Flop (didn't bet)
Seat 9: chrisg1987 folded on the Flop



PokerStars Hand #201496745315: Tournament #2632284264, 17000+3000 Hold'em No Limit - Level I (10/20) - 2019/06/17 21:39:37 ET
Table '2632284264 3' 9-max Seat #2 is the button
Seat 1: O Aprendi105 (1300 in chips) 
Seat 2: HSagerbaf (1940 in chips) 
Seat 3: Taargeett (1440 in chips) 
Seat 4: Coolie_1963 (1500 in chips) 
Seat 5: DPALMA2017 (1500 in chips) 
Seat 6: PhxdB420 (1380 in chips) 
Seat 7: IKE67701 (1500 in chips) 
Seat 8: concorddeadi (1500 in chips) 
Seat 9: chrisg1987 (1440 in chips) 
Taargeett: posts small blind 10
Coolie_1963: posts big blind 20
*** HOLE CARDS ***
Dealt to Taargeett [8s 2h]
DPALMA2017: calls 20
PhxdB420: folds 
IKE67701: folds 
concorddeadi: calls 20
chrisg1987: calls 20
O Aprendi105: raises 40 to 60
HSagerbaf: calls 60
Taargeett: folds 
Coolie_1963: calls 40
DPALMA2017: calls 40
concorddeadi: calls 40
chrisg1987: calls 40
*** FLOP *** [Tc 9d Qc]
Coolie_1963: checks 
DPALMA2017: checks 
concorddeadi: bets 20
chrisg1987: folds 
O Aprendi105: calls 20
HSagerbaf: calls 20
Coolie_1963: calls 20
DPALMA2017: raises 80 to 100
concorddeadi: calls 80
O Aprendi105: folds 
HSagerbaf: calls 80
Coolie_1963: folds 
*** TURN *** [Tc 9d Qc] [2d]
DPALMA2017: checks 
concorddeadi: checks 
HSagerbaf: checks 
*** RIVER *** [Tc 9d Qc 2d] [Jh]
DPALMA2017: bets 710
concorddeadi: folds 
HSagerbaf: calls 710
*** SHOW DOWN ***
DPALMA2017: shows [2c Jc] (two pair, Jacks and Deuces)
HSagerbaf: shows [Kc 9s] (a straight, Nine to King)
HSagerbaf collected 2130 from pot
*** SUMMARY ***
Total pot 2130 | Rake 0 
Board [Tc 9d Qc 2d Jh]
Seat 1: O Aprendi105 folded on the Flop
Seat 2: HSagerbaf (button) showed [Kc 9s] and won (2130) with a straight, Nine to King
Seat 3: Taargeett (small blind) folded before Flop
Seat 4: Coolie_1963 (big blind) folded on the Flop
Seat 5: DPALMA2017 showed [2c Jc] and lost with two pair, Jacks and Deuces
Seat 6: PhxdB420 folded before Flop (didn't bet)
Seat 7: IKE67701 folded before Flop (didn't bet)
Seat 8: concorddeadi folded on the River
Seat 9: chrisg1987 folded on the Flop



PokerStars Hand #201496766901: Tournament #2632284264, 17000+3000 Hold'em No Limit - Level I (10/20) - 2019/06/17 21:40:57 ET
Table '2632284264 3' 9-max Seat #3 is the button
Seat 1: O Aprendi105 (1220 in chips) 
Seat 2: HSagerbaf (3200 in chips) 
Seat 3: Taargeett (1430 in chips) 
Seat 4: Coolie_1963 (1420 in chips) 
Seat 5: DPALMA2017 (630 in chips) 
Seat 6: PhxdB420 (1380 in chips) 
Seat 7: IKE67701 (1500 in chips) 
Seat 8: concorddeadi (1340 in chips) 
Seat 9: chrisg1987 (1380 in chips) 
Coolie_1963: posts small blind 10
DPALMA2017: posts big blind 20
*** HOLE CARDS ***
Dealt to Taargeett [Ks 5s]
PhxdB420: folds 
IKE67701: folds 
concorddeadi: calls 20
chrisg1987: calls 20
O Aprendi105: folds 
HSagerbaf: calls 20
Taargeett: raises 20 to 40
Coolie_1963: calls 30
DPALMA2017: raises 60 to 100
concorddeadi: calls 80
chrisg1987: calls 80
HSagerbaf: calls 80
Taargeett: folds 
Coolie_1963: calls 60
*** FLOP *** [Jd 9s Qd]
Coolie_1963: bets 1320 and is all-in
DPALMA2017: calls 530 and is all-in
concorddeadi: calls 1240 and is all-in
chrisg1987: calls 1280 and is all-in
HSagerbaf: calls 1320
*** TURN *** [Jd 9s Qd] [3s]
*** RIVER *** [Jd 9s Qd 3s] [9d]
*** SHOW DOWN ***
Coolie_1963: shows [5c Qc] (two pair, Queens and Nines)
HSagerbaf: shows [Kc Js] (two pair, Jacks and Nines)
Coolie_1963 collected 80 from side pot-3 
chrisg1987: shows [4d 5d] (a flush, Queen high)
chrisg1987 collected 120 from side pot-2 
concorddeadi: shows [Qh 9h] (a full house, Nines full of Queens)
concorddeadi collected 2840 from side pot-1 
DPALMA2017: shows [As 9c] (three of a kind, Nines)
concorddeadi collected 3190 from main pot
DPALMA2017 finished the tournament in 45th place
*** SUMMARY ***
Total pot 6230 Main pot 3190. Side pot-1 2840. Side pot-2 120. Side pot-3 80. | Rake 0 
Board [Jd 9s Qd 3s 9d]
Seat 1: O Aprendi105 folded before Flop (didn't bet)
Seat 2: HSagerbaf showed [Kc Js] and lost with two pair, Jacks and Nines
Seat 3: Taargeett (button) folded before Flop
Seat 4: Coolie_1963 (small blind) showed [5c Qc] and won (80) with two pair, Queens and Nines
Seat 5: DPALMA2017 (big blind) showed [As 9c] and lost with three of a kind, Nines
Seat 6: PhxdB420 folded before Flop (didn't bet)
Seat 7: IKE67701 folded before Flop (didn't bet)
Seat 8: concorddeadi showed [Qh 9h] and won (6030) with a full house, Nines full of Queens
Seat 9: chrisg1987 showed [4d 5d] and won (120) with a flush, Queen high



PokerStars Hand #201496782795: Tournament #2632284264, 17000+3000 Hold'em No Limit - Level I (10/20) - 2019/06/17 21:41:56 ET
Table '2632284264 3' 9-max Seat #4 is the button
Seat 1: O Aprendi105 (1220 in chips) 
Seat 2: HSagerbaf (1780 in chips) 
Seat 3: Taargeett (1390 in chips) 
Seat 4: Coolie_1963 (80 in chips) 
Seat 6: PhxdB420 (1380 in chips) 
Seat 7: IKE67701 (1500 in chips) 
Seat 8: concorddeadi (6030 in chips) 
Seat 9: chrisg1987 (120 in chips) 
PhxdB420: posts small blind 10
IKE67701: posts big blind 20
*** HOLE CARDS ***
Dealt to Taargeett [8d 7s]
concorddeadi: calls 20
chrisg1987: raises 100 to 120 and is all-in
O Aprendi105: folds 
HSagerbaf: calls 120
Taargeett: folds 
Coolie_1963: calls 80 and is all-in
PhxdB420: calls 110
IKE67701: calls 100
concorddeadi: calls 100
*** FLOP *** [Kh 2c Jd]
PhxdB420: bets 300
IKE67701: folds 
concorddeadi: calls 300
HSagerbaf: folds 
*** TURN *** [Kh 2c Jd] [Ac]
PhxdB420: bets 450
concorddeadi: calls 450
*** RIVER *** [Kh 2c Jd Ac] [Ah]
PhxdB420: bets 510 and is all-in
concorddeadi: calls 510
*** SHOW DOWN ***
PhxdB420: shows [Qh Kd] (two pair, Aces and Kings)
concorddeadi: shows [Kc 9s] (two pair, Aces and Kings - lower kicker)
PhxdB420 collected 2520 from side pot-2 
chrisg1987: shows [Th Qs] (a straight, Ten to Ace)
chrisg1987 collected 200 from side pot-1 
Coolie_1963: shows [3s 4d] (a pair of Aces)
chrisg1987 collected 480 from main pot
Coolie_1963 finished the tournament in 42nd place
*** SUMMARY ***
Total pot 3200 Main pot 480. Side pot-1 200. Side pot-2 2520. | Rake 0 
Board [Kh 2c Jd Ac Ah]
Seat 1: O Aprendi105 folded before Flop (didn't bet)
Seat 2: HSagerbaf folded on the Flop
Seat 3: Taargeett folded before Flop (didn't bet)
Seat 4: Coolie_1963 (button) showed [3s 4d] and lost with a pair of Aces
Seat 6: PhxdB420 (small blind) showed [Qh Kd] and won (2520) with two pair, Aces and Kings
Seat 7: IKE67701 (big blind) folded on the Flop
Seat 8: concorddeadi showed [Kc 9s] and lost with two pair, Aces and Kings
Seat 9: chrisg1987 showed [Th Qs] and won (680) with a straight, Ten to Ace



PokerStars Hand #201496803147: Tournament #2632284264, 17000+3000 Hold'em No Limit - Level I (10/20) - 2019/06/17 21:43:10 ET
Table '2632284264 3' 9-max Seat #6 is the button
Seat 1: O Aprendi105 (1220 in chips) 
Seat 2: HSagerbaf (1660 in chips) 
Seat 3: Taargeett (1390 in chips) 
Seat 6: PhxdB420 (2520 in chips) 
Seat 7: IKE67701 (1380 in chips) 
Seat 8: concorddeadi (4650 in chips) 
Seat 9: chrisg1987 (680 in chips) 
IKE67701: posts small blind 10
concorddeadi: posts big blind 20
*** HOLE CARDS ***
Dealt to Taargeett [4d Qd]
chrisg1987: folds 
O Aprendi105: raises 20 to 40
HSagerbaf: folds 
Taargeett: raises 20 to 60
PhxdB420: folds 
IKE67701: folds 
concorddeadi: calls 40
O Aprendi105: calls 20
*** FLOP *** [Qs Ad 4s]
concorddeadi: checks 
O Aprendi105: bets 95
Taargeett: raises 95 to 190
concorddeadi: folds 
O Aprendi105: calls 95
*** TURN *** [Qs Ad 4s] [7h]
O Aprendi105: bets 285
Taargeett: raises 285 to 570
O Aprendi105: calls 285
*** RIVER *** [Qs Ad 4s 7h] [Qh]
O Aprendi105: checks 
Taargeett: bets 560
O Aprendi105: folds 
Uncalled bet (560) returned to Taargeett
Taargeett collected 1710 from pot
Taargeett: doesn't show hand 
*** SUMMARY ***
Total pot 1710 | Rake 0 
Board [Qs Ad 4s 7h Qh]
Seat 1: O Aprendi105 folded on the River
Seat 2: HSagerbaf folded before Flop (didn't bet)
Seat 3: Taargeett collected (1710)
Seat 6: PhxdB420 (button) folded before Flop (didn't bet)
Seat 7: IKE67701 (small blind) folded before Flop
Seat 8: concorddeadi (big blind) folded on the Flop
Seat 9: chrisg1987 folded before Flop (didn't bet)



PokerStars Hand #201496820295: Tournament #2632284264, 17000+3000 Hold'em No Limit - Level II (15/30) - 2019/06/17 21:44:14 ET
Table '2632284264 3' 9-max Seat #7 is the button
Seat 1: O Aprendi105 (400 in chips) 
Seat 2: HSagerbaf (1660 in chips) 
Seat 3: Taargeett (2280 in chips) 
Seat 4: Gilmar735 (1670 in chips) 
Seat 6: PhxdB420 (2520 in chips) 
Seat 7: IKE67701 (1370 in chips) 
Seat 8: concorddeadi (4590 in chips) 
Seat 9: chrisg1987 (680 in chips) 
concorddeadi: posts small blind 15
chrisg1987: posts big blind 30
*** HOLE CARDS ***
Dealt to Taargeett [Qc 5s]
O Aprendi105: folds 
HSagerbaf: calls 30
Taargeett: folds 
Gilmar735: calls 30
PhxdB420: folds 
IKE67701: folds 
concorddeadi: folds 
chrisg1987: checks 
*** FLOP *** [2d Jd Jc]
chrisg1987: checks 
HSagerbaf: checks 
Gilmar735: bets 30
chrisg1987: folds 
HSagerbaf: calls 30
*** TURN *** [2d Jd Jc] [Th]
HSagerbaf: checks 
Gilmar735: bets 30
HSagerbaf: calls 30
*** RIVER *** [2d Jd Jc Th] [Qd]
HSagerbaf: bets 90
Gilmar735: raises 203 to 293
HSagerbaf: calls 203
*** SHOW DOWN ***
Gilmar735: shows [Kd Ad] (a flush, Ace high)
HSagerbaf: mucks hand 
Gilmar735 collected 811 from pot
*** SUMMARY ***
Total pot 811 | Rake 0 
Board [2d Jd Jc Th Qd]
Seat 1: O Aprendi105 folded before Flop (didn't bet)
Seat 2: HSagerbaf mucked [Qh 7d]
Seat 3: Taargeett folded before Flop (didn't bet)
Seat 4: Gilmar735 showed [Kd Ad] and won (811) with a flush, Ace high
Seat 6: PhxdB420 folded before Flop (didn't bet)
Seat 7: IKE67701 (button) folded before Flop (didn't bet)
Seat 8: concorddeadi (small blind) folded before Flop
Seat 9: chrisg1987 (big blind) folded on the Flop



PokerStars Hand #201496843633: Tournament #2632284264, 17000+3000 Hold'em No Limit - Level II (15/30) - 2019/06/17 21:45:10 ET
Table '2632284264 3' 9-max Seat #8 is the button
Seat 1: O Aprendi105 (400 in chips) 
Seat 2: HSagerbaf (1277 in chips) 
Seat 3: Taargeett (2280 in chips) 
Seat 4: Gilmar735 (2098 in chips) 
Seat 6: PhxdB420 (2520 in chips) 
Seat 7: IKE67701 (1370 in chips) 
Seat 8: concorddeadi (4575 in chips) 
Seat 9: chrisg1987 (650 in chips) 
chrisg1987: posts small blind 15
O Aprendi105: posts big blind 30
*** HOLE CARDS ***
Dealt to Taargeett [8c 3c]
HSagerbaf: calls 30
Taargeett: folds 
Gilmar735: folds 
PhxdB420: folds 
IKE67701: calls 30
concorddeadi: raises 30 to 60
chrisg1987: calls 45
O Aprendi105: raises 340 to 400 and is all-in
HSagerbaf: calls 370
IKE67701: calls 370
concorddeadi: calls 340
chrisg1987: folds 
*** FLOP *** [2s 7h Ac]
HSagerbaf: checks 
IKE67701: checks 
concorddeadi: checks 
*** TURN *** [2s 7h Ac] [4s]
HSagerbaf: checks 
IKE67701: checks 
concorddeadi: checks 
*** RIVER *** [2s 7h Ac 4s] [7s]
HSagerbaf: bets 877 and is all-in
IKE67701: folds 
concorddeadi: calls 877
*** SHOW DOWN ***
HSagerbaf: shows [8s 6s] (a flush, Eight high)
concorddeadi: shows [Qs Qc] (two pair, Queens and Sevens)
HSagerbaf collected 1754 from side pot
O Aprendi105: shows [9d Td] (a pair of Sevens)
HSagerbaf collected 1660 from main pot
O Aprendi105 finished the tournament in 41st place
*** SUMMARY ***
Total pot 3414 Main pot 1660. Side pot 1754. | Rake 0 
Board [2s 7h Ac 4s 7s]
Seat 1: O Aprendi105 (big blind) showed [9d Td] and lost with a pair of Sevens
Seat 2: HSagerbaf showed [8s 6s] and won (3414) with a flush, Eight high
Seat 3: Taargeett folded before Flop (didn't bet)
Seat 4: Gilmar735 folded before Flop (didn't bet)
Seat 6: PhxdB420 folded before Flop (didn't bet)
Seat 7: IKE67701 folded on the River
Seat 8: concorddeadi (button) showed [Qs Qc] and lost with two pair, Queens and Sevens
Seat 9: chrisg1987 (small blind) folded before Flop



PokerStars Hand #201496859863: Tournament #2632284264, 17000+3000 Hold'em No Limit - Level II (15/30) - 2019/06/17 21:46:10 ET
Table '2632284264 3' 9-max Seat #9 is the button
Seat 2: HSagerbaf (3414 in chips) 
Seat 3: Taargeett (2280 in chips) 
Seat 4: Gilmar735 (2098 in chips) 
Seat 6: PhxdB420 (2520 in chips) 
Seat 7: IKE67701 (970 in chips) 
Seat 8: concorddeadi (3298 in chips) 
Seat 9: chrisg1987 (590 in chips) 
HSagerbaf: posts small blind 15
Taargeett: posts big blind 30
*** HOLE CARDS ***
Dealt to Taargeett [Ad 5c]
Gilmar735: folds 
PhxdB420: folds 
IKE67701: folds 
concorddeadi: folds 
chrisg1987: raises 560 to 590 and is all-in
HSagerbaf: folds 
Taargeett: folds 
Uncalled bet (560) returned to chrisg1987
chrisg1987 collected 75 from pot
chrisg1987: doesn't show hand 
*** SUMMARY ***
Total pot 75 | Rake 0 
Seat 2: HSagerbaf (small blind) folded before Flop
Seat 3: Taargeett (big blind) folded before Flop
Seat 4: Gilmar735 folded before Flop (didn't bet)
Seat 6: PhxdB420 folded before Flop (didn't bet)
Seat 7: IKE67701 folded before Flop (didn't bet)
Seat 8: concorddeadi folded before Flop (didn't bet)
Seat 9: chrisg1987 (button) collected (75)



PokerStars Hand #201496864283: Tournament #2632284264, 17000+3000 Hold'em No Limit - Level II (15/30) - 2019/06/17 21:46:26 ET
Table '2632284264 3' 9-max Seat #2 is the button
Seat 2: HSagerbaf (3399 in chips) 
Seat 3: Taargeett (2250 in chips) 
Seat 4: Gilmar735 (2098 in chips) 
Seat 6: PhxdB420 (2520 in chips) 
Seat 7: IKE67701 (970 in chips) 
Seat 8: concorddeadi (3298 in chips) 
Seat 9: chrisg1987 (635 in chips) 
Taargeett: posts small blind 15
Gilmar735: posts big blind 30
*** HOLE CARDS ***
Dealt to Taargeett [6c Qc]
PhxdB420: folds 
IKE67701: folds 
concorddeadi: folds 
chrisg1987: folds 
HSagerbaf: calls 30
Taargeett: calls 15
Gilmar735: checks 
*** FLOP *** [4d 4c 9h]
Taargeett: checks 
Gilmar735: checks 
HSagerbaf: checks 
*** TURN *** [4d 4c 9h] [4s]
Taargeett: bets 30
Gilmar735: folds 
HSagerbaf: calls 30
*** RIVER *** [4d 4c 9h 4s] [Jd]
Taargeett: bets 30
HSagerbaf: calls 30
*** SHOW DOWN ***
Taargeett: shows [6c Qc] (three of a kind, Fours)
HSagerbaf: shows [As Qd] (three of a kind, Fours - Ace kicker)
HSagerbaf collected 210 from pot
*** SUMMARY ***
Total pot 210 | Rake 0 
Board [4d 4c 9h 4s Jd]
Seat 2: HSagerbaf (button) showed [As Qd] and won (210) with three of a kind, Fours
Seat 3: Taargeett (small blind) showed [6c Qc] and lost with three of a kind, Fours
Seat 4: Gilmar735 (big blind) folded on the Turn
Seat 6: PhxdB420 folded before Flop (didn't bet)
Seat 7: IKE67701 folded before Flop (didn't bet)
Seat 8: concorddeadi folded before Flop (didn't bet)
Seat 9: chrisg1987 folded before Flop (didn't bet)



PokerStars Hand #201496877106: Tournament #2632284264, 17000+3000 Hold'em No Limit - Level II (15/30) - 2019/06/17 21:47:14 ET
Table '2632284264 3' 9-max Seat #3 is the button
Seat 2: HSagerbaf (3519 in chips) 
Seat 3: Taargeett (2160 in chips) 
Seat 4: Gilmar735 (2068 in chips) 
Seat 6: PhxdB420 (2520 in chips) 
Seat 7: IKE67701 (970 in chips) 
Seat 8: concorddeadi (3298 in chips) 
Seat 9: chrisg1987 (635 in chips) 
Gilmar735: posts small blind 15
PhxdB420: posts big blind 30
*** HOLE CARDS ***
Dealt to Taargeett [6c 7c]
IKE67701 has timed out
IKE67701: folds 
concorddeadi: folds 
chrisg1987: folds 
HSagerbaf: calls 30
Taargeett: raises 60 to 90
Gilmar735: folds 
PhxdB420: folds 
HSagerbaf: calls 60
*** FLOP *** [Tc Qs 2d]
HSagerbaf: checks 
Taargeett: checks 
*** TURN *** [Tc Qs 2d] [5h]
HSagerbaf: checks 
Taargeett: bets 225
HSagerbaf: calls 225
*** RIVER *** [Tc Qs 2d 5h] [Jc]
HSagerbaf: checks 
Taargeett: bets 675
HSagerbaf: folds 
Uncalled bet (675) returned to Taargeett
Taargeett collected 675 from pot
Taargeett: doesn't show hand 
*** SUMMARY ***
Total pot 675 | Rake 0 
Board [Tc Qs 2d 5h Jc]
Seat 2: HSagerbaf folded on the River
Seat 3: Taargeett (button) collected (675)
Seat 4: Gilmar735 (small blind) folded before Flop
Seat 6: PhxdB420 (big blind) folded before Flop
Seat 7: IKE67701 folded before Flop (didn't bet)
Seat 8: concorddeadi folded before Flop (didn't bet)
Seat 9: chrisg1987 folded before Flop (didn't bet)



PokerStars Hand #201496893797: Tournament #2632284264, 17000+3000 Hold'em No Limit - Level II (15/30) - 2019/06/17 21:48:17 ET
Table '2632284264 3' 9-max Seat #4 is the button
Seat 2: HSagerbaf (3204 in chips) 
Seat 3: Taargeett (2520 in chips) 
Seat 4: Gilmar735 (2053 in chips) 
Seat 6: PhxdB420 (2490 in chips) 
Seat 7: IKE67701 (970 in chips) 
Seat 8: concorddeadi (3298 in chips) 
Seat 9: chrisg1987 (635 in chips) 
PhxdB420: posts small blind 15
IKE67701: posts big blind 30
*** HOLE CARDS ***
Dealt to Taargeett [2c 3h]
concorddeadi: folds 
chrisg1987: folds 
HSagerbaf: calls 30
Taargeett: folds 
Gilmar735: folds 
PhxdB420: folds 
IKE67701: checks 
*** FLOP *** [Td Kh 6s]
IKE67701: bets 30
HSagerbaf: calls 30
*** TURN *** [Td Kh 6s] [7s]
IKE67701: bets 30
HSagerbaf: calls 30
*** RIVER *** [Td Kh 6s 7s] [4c]
IKE67701: bets 30
HSagerbaf: calls 30
*** SHOW DOWN ***
IKE67701: shows [Ks Jh] (a pair of Kings)
HSagerbaf: mucks hand 
IKE67701 collected 255 from pot
*** SUMMARY ***
Total pot 255 | Rake 0 
Board [Td Kh 6s 7s 4c]
Seat 2: HSagerbaf mucked [As Qh]
Seat 3: Taargeett folded before Flop (didn't bet)
Seat 4: Gilmar735 (button) folded before Flop (didn't bet)
Seat 6: PhxdB420 (small blind) folded before Flop
Seat 7: IKE67701 (big blind) showed [Ks Jh] and won (255) with a pair of Kings
Seat 8: concorddeadi folded before Flop (didn't bet)
Seat 9: chrisg1987 folded before Flop (didn't bet)



PokerStars Hand #201496907092: Tournament #2632284264, 17000+3000 Hold'em No Limit - Level III (25/50) - 2019/06/17 21:49:06 ET
Table '2632284264 3' 9-max Seat #6 is the button
Seat 2: HSagerbaf (3084 in chips) 
Seat 3: Taargeett (2520 in chips) 
Seat 4: Gilmar735 (2053 in chips) 
Seat 6: PhxdB420 (2475 in chips) 
Seat 7: IKE67701 (1105 in chips) 
Seat 8: concorddeadi (3298 in chips) 
Seat 9: chrisg1987 (635 in chips) 
IKE67701: posts small blind 25
concorddeadi: posts big blind 50
*** HOLE CARDS ***
Dealt to Taargeett [8c 3d]
chrisg1987: calls 50
HSagerbaf: folds 
Taargeett: folds 
Gilmar735: folds 
PhxdB420: raises 100 to 150
IKE67701: folds 
concorddeadi: calls 100
chrisg1987: calls 100
*** FLOP *** [5s 9c Jd]
concorddeadi: checks 
chrisg1987: bets 485 and is all-in
PhxdB420: calls 485
concorddeadi: folds 
*** TURN *** [5s 9c Jd] [4s]
*** RIVER *** [5s 9c Jd 4s] [Ts]
*** SHOW DOWN ***
chrisg1987: shows [Jc Tc] (two pair, Jacks and Tens)
PhxdB420: shows [Kc Qh] (a straight, Nine to King)
PhxdB420 collected 1445 from pot
chrisg1987 finished the tournament in 38th place
*** SUMMARY ***
Total pot 1445 | Rake 0 
Board [5s 9c Jd 4s Ts]
Seat 2: HSagerbaf folded before Flop (didn't bet)
Seat 3: Taargeett folded before Flop (didn't bet)
Seat 4: Gilmar735 folded before Flop (didn't bet)
Seat 6: PhxdB420 (button) showed [Kc Qh] and won (1445) with a straight, Nine to King
Seat 7: IKE67701 (small blind) folded before Flop
Seat 8: concorddeadi (big blind) folded on the Flop
Seat 9: chrisg1987 showed [Jc Tc] and lost with two pair, Jacks and Tens



PokerStars Hand #201496920568: Tournament #2632284264, 17000+3000 Hold'em No Limit - Level III (25/50) - 2019/06/17 21:49:57 ET
Table '2632284264 3' 9-max Seat #7 is the button
Seat 2: HSagerbaf (3084 in chips) 
Seat 3: Taargeett (2520 in chips) 
Seat 4: Gilmar735 (2053 in chips) 
Seat 6: PhxdB420 (3285 in chips) 
Seat 7: IKE67701 (1080 in chips) 
Seat 8: concorddeadi (3148 in chips) 
concorddeadi: posts small blind 25
HSagerbaf: posts big blind 50
*** HOLE CARDS ***
Dealt to Taargeett [Ad 7c]
Taargeett: folds 
Gilmar735: folds 
PhxdB420: raises 100 to 150
IKE67701: folds 
concorddeadi: folds 
HSagerbaf: folds 
Uncalled bet (100) returned to PhxdB420
PhxdB420 collected 125 from pot
PhxdB420: doesn't show hand 
*** SUMMARY ***
Total pot 125 | Rake 0 
Seat 2: HSagerbaf (big blind) folded before Flop
Seat 3: Taargeett folded before Flop (didn't bet)
Seat 4: Gilmar735 folded before Flop (didn't bet)
Seat 6: PhxdB420 collected (125)
Seat 7: IKE67701 (button) folded before Flop (didn't bet)
Seat 8: concorddeadi (small blind) folded before Flop



PokerStars Hand #201496925784: Tournament #2632284264, 17000+3000 Hold'em No Limit - Level III (25/50) - 2019/06/17 21:50:16 ET
Table '2632284264 3' 9-max Seat #8 is the button
Seat 2: HSagerbaf (3034 in chips) 
Seat 3: Taargeett (2520 in chips) 
Seat 4: Gilmar735 (2053 in chips) 
Seat 6: PhxdB420 (3360 in chips) 
Seat 7: IKE67701 (1080 in chips) 
Seat 8: concorddeadi (3123 in chips) 
HSagerbaf: posts small blind 25
Taargeett: posts big blind 50
*** HOLE CARDS ***
Dealt to Taargeett [7c Jc]
Gilmar735: folds 
PhxdB420: folds 
IKE67701: folds 
concorddeadi: calls 50
HSagerbaf: calls 25
Taargeett: checks 
*** FLOP *** [3s 6h Qc]
HSagerbaf: checks 
Taargeett: checks 
concorddeadi: checks 
*** TURN *** [3s 6h Qc] [Ac]
HSagerbaf: checks 
Taargeett: bets 100
concorddeadi: calls 100
HSagerbaf: calls 100
*** RIVER *** [3s 6h Qc Ac] [Kc]
HSagerbaf: checks 
Taargeett: bets 250
concorddeadi: calls 250
HSagerbaf: folds 
*** SHOW DOWN ***
Taargeett: shows [7c Jc] (a flush, Ace high)
concorddeadi: mucks hand 
Taargeett collected 950 from pot
*** SUMMARY ***
Total pot 950 | Rake 0 
Board [3s 6h Qc Ac Kc]
Seat 2: HSagerbaf (small blind) folded on the River
Seat 3: Taargeett (big blind) showed [7c Jc] and won (950) with a flush, Ace high
Seat 4: Gilmar735 folded before Flop (didn't bet)
Seat 6: PhxdB420 folded before Flop (didn't bet)
Seat 7: IKE67701 folded before Flop (didn't bet)
Seat 8: concorddeadi (button) mucked [Ah Jh]



PokerStars Hand #201496944184: Tournament #2632284264, 17000+3000 Hold'em No Limit - Level III (25/50) - 2019/06/17 21:51:25 ET
Table '2632284264 3' 9-max Seat #2 is the button
Seat 1: CARDBURR (1515 in chips) 
Seat 2: HSagerbaf (2884 in chips) 
Seat 3: Taargeett (3070 in chips) 
Seat 4: Gilmar735 (2053 in chips) 
Seat 5: timetrvlr (1260 in chips) 
Seat 6: PhxdB420 (3360 in chips) 
Seat 7: IKE67701 (1080 in chips) 
Seat 8: concorddeadi (2723 in chips) 
Seat 9: BDSattva (2175 in chips) 
Taargeett: posts small blind 25
Gilmar735: posts big blind 50
*** HOLE CARDS ***
Dealt to Taargeett [5c 8h]
timetrvlr: calls 50
PhxdB420: raises 100 to 150
IKE67701: folds 
concorddeadi: folds 
BDSattva: folds 
CARDBURR: folds 
HSagerbaf: folds 
Taargeett: folds 
Gilmar735: calls 100
timetrvlr: calls 100
*** FLOP *** [8d 6c 2d]
Gilmar735: bets 50
timetrvlr: folds 
PhxdB420: raises 325 to 375
Gilmar735: calls 325
*** TURN *** [8d 6c 2d] [4s]
Gilmar735: bets 613
PhxdB420: raises 2222 to 2835 and is all-in
Gilmar735: calls 915 and is all-in
Uncalled bet (1307) returned to PhxdB420
*** RIVER *** [8d 6c 2d 4s] [Ts]
*** SHOW DOWN ***
Gilmar735: shows [5d 7d] (a straight, Four to Eight)
PhxdB420: shows [4d 4c] (three of a kind, Fours)
Gilmar735 collected 4281 from pot
*** SUMMARY ***
Total pot 4281 | Rake 0 
Board [8d 6c 2d 4s Ts]
Seat 1: CARDBURR folded before Flop (didn't bet)
Seat 2: HSagerbaf (button) folded before Flop (didn't bet)
Seat 3: Taargeett (small blind) folded before Flop
Seat 4: Gilmar735 (big blind) showed [5d 7d] and won (4281) with a straight, Four to Eight
Seat 5: timetrvlr folded on the Flop
Seat 6: PhxdB420 showed [4d 4c] and lost with three of a kind, Fours
Seat 7: IKE67701 folded before Flop (didn't bet)
Seat 8: concorddeadi folded before Flop (didn't bet)
Seat 9: BDSattva folded before Flop (didn't bet)



PokerStars Hand #201496961952: Tournament #2632284264, 17000+3000 Hold'em No Limit - Level III (25/50) - 2019/06/17 21:52:32 ET
Table '2632284264 3' 9-max Seat #3 is the button
Seat 1: CARDBURR (1515 in chips) 
Seat 2: HSagerbaf (2884 in chips) 
Seat 3: Taargeett (3045 in chips) 
Seat 4: Gilmar735 (4281 in chips) 
Seat 5: timetrvlr (1110 in chips) 
Seat 6: PhxdB420 (1307 in chips) 
Seat 7: IKE67701 (1080 in chips) 
Seat 8: concorddeadi (2723 in chips) 
Seat 9: BDSattva (2175 in chips) 
Gilmar735: posts small blind 25
timetrvlr: posts big blind 50
*** HOLE CARDS ***
Dealt to Taargeett [4c 5c]
PhxdB420: folds 
IKE67701: calls 50
concorddeadi: folds 
BDSattva: calls 50
CARDBURR: calls 50
HSagerbaf: folds 
Taargeett: raises 100 to 150
Gilmar735: folds 
timetrvlr: folds 
IKE67701: calls 100
BDSattva: calls 100
CARDBURR: calls 100
*** FLOP *** [Qd 4d 9c]
IKE67701: checks 
BDSattva: checks 
CARDBURR: checks 
Taargeett: bets 200
IKE67701: folds 
BDSattva: folds 
CARDBURR: folds 
Uncalled bet (200) returned to Taargeett
Taargeett collected 675 from pot
Taargeett: doesn't show hand 
*** SUMMARY ***
Total pot 675 | Rake 0 
Board [Qd 4d 9c]
Seat 1: CARDBURR folded on the Flop
Seat 2: HSagerbaf folded before Flop (didn't bet)
Seat 3: Taargeett (button) collected (675)
Seat 4: Gilmar735 (small blind) folded before Flop
Seat 5: timetrvlr (big blind) folded before Flop
Seat 6: PhxdB420 folded before Flop (didn't bet)
Seat 7: IKE67701 folded on the Flop
Seat 8: concorddeadi folded before Flop (didn't bet)
Seat 9: BDSattva folded on the Flop



PokerStars Hand #201496974186: Tournament #2632284264, 17000+3000 Hold'em No Limit - Level III (25/50) - 2019/06/17 21:53:18 ET
Table '2632284264 3' 9-max Seat #4 is the button
Seat 1: CARDBURR (1365 in chips) 
Seat 2: HSagerbaf (2884 in chips) 
Seat 3: Taargeett (3570 in chips) 
Seat 4: Gilmar735 (4256 in chips) 
Seat 5: timetrvlr (1060 in chips) 
Seat 6: PhxdB420 (1307 in chips) 
Seat 7: IKE67701 (930 in chips) 
Seat 8: concorddeadi (2723 in chips) 
Seat 9: BDSattva (2025 in chips) 
timetrvlr: posts small blind 25
PhxdB420: posts big blind 50
*** HOLE CARDS ***
Dealt to Taargeett [4s Qd]
IKE67701: folds 
concorddeadi: folds 
BDSattva: raises 125 to 175
CARDBURR: folds 
HSagerbaf: folds 
Taargeett: folds 
Gilmar735: folds 
timetrvlr: folds 
PhxdB420: folds 
Uncalled bet (125) returned to BDSattva
BDSattva collected 125 from pot
*** SUMMARY ***
Total pot 125 | Rake 0 
Seat 1: CARDBURR folded before Flop (didn't bet)
Seat 2: HSagerbaf folded before Flop (didn't bet)
Seat 3: Taargeett folded before Flop (didn't bet)
Seat 4: Gilmar735 (button) folded before Flop (didn't bet)
Seat 5: timetrvlr (small blind) folded before Flop
Seat 6: PhxdB420 (big blind) folded before Flop
Seat 7: IKE67701 folded before Flop (didn't bet)
Seat 8: concorddeadi folded before Flop (didn't bet)
Seat 9: BDSattva collected (125)



PokerStars Hand #201496981617: Tournament #2632284264, 17000+3000 Hold'em No Limit - Level IV (50/100) - 2019/06/17 21:53:46 ET
Table '2632284264 3' 9-max Seat #5 is the button
Seat 1: CARDBURR (1365 in chips) 
Seat 2: HSagerbaf (2884 in chips) 
Seat 3: Taargeett (3570 in chips) 
Seat 4: Gilmar735 (4256 in chips) 
Seat 5: timetrvlr (1035 in chips) 
Seat 6: PhxdB420 (1257 in chips) 
Seat 7: IKE67701 (930 in chips) 
Seat 8: concorddeadi (2723 in chips) 
Seat 9: BDSattva (2100 in chips) 
PhxdB420: posts small blind 50
IKE67701: posts big blind 100
*** HOLE CARDS ***
Dealt to Taargeett [8d 6h]
concorddeadi has timed out
concorddeadi: folds 
BDSattva: raises 200 to 300
CARDBURR: folds 
HSagerbaf: folds 
Taargeett: folds 
Gilmar735: calls 300
timetrvlr: folds 
PhxdB420: folds 
IKE67701: folds 
*** FLOP *** [Qs 9h Ac]
BDSattva: checks 
Gilmar735: checks 
*** TURN *** [Qs 9h Ac] [Jh]
BDSattva: checks 
Gilmar735: bets 100
BDSattva: calls 100
*** RIVER *** [Qs 9h Ac Jh] [6c]
BDSattva: checks 
Gilmar735: bets 475
BDSattva: folds [Th Td]
Uncalled bet (475) returned to Gilmar735
Gilmar735 collected 950 from pot
*** SUMMARY ***
Total pot 950 | Rake 0 
Board [Qs 9h Ac Jh 6c]
Seat 1: CARDBURR folded before Flop (didn't bet)
Seat 2: HSagerbaf folded before Flop (didn't bet)
Seat 3: Taargeett folded before Flop (didn't bet)
Seat 4: Gilmar735 collected (950)
Seat 5: timetrvlr (button) folded before Flop (didn't bet)
Seat 6: PhxdB420 (small blind) folded before Flop
Seat 7: IKE67701 (big blind) folded before Flop
Seat 8: concorddeadi folded before Flop (didn't bet)
Seat 9: BDSattva folded on the River



PokerStars Hand #201496997008: Tournament #2632284264, 17000+3000 Hold'em No Limit - Level IV (50/100) - 2019/06/17 21:54:45 ET
Table '2632284264 3' 9-max Seat #6 is the button
Seat 1: CARDBURR (1365 in chips) 
Seat 2: HSagerbaf (2884 in chips) 
Seat 3: Taargeett (3570 in chips) 
Seat 4: Gilmar735 (4806 in chips) 
Seat 5: timetrvlr (1035 in chips) 
Seat 6: PhxdB420 (1207 in chips) 
Seat 7: IKE67701 (830 in chips) 
Seat 8: concorddeadi (2723 in chips) 
Seat 9: BDSattva (1700 in chips) 
IKE67701: posts small blind 50
concorddeadi: posts big blind 100
*** HOLE CARDS ***
Dealt to Taargeett [5c 9h]
BDSattva: folds 
CARDBURR: folds 
HSagerbaf: calls 100
Taargeett: folds 
Gilmar735: folds 
timetrvlr: folds 
PhxdB420: folds 
IKE67701: folds 
concorddeadi: checks 
*** FLOP *** [9d Kc Ad]
concorddeadi: checks 
HSagerbaf: bets 100
concorddeadi: folds 
Uncalled bet (100) returned to HSagerbaf
HSagerbaf collected 250 from pot
HSagerbaf: doesn't show hand 
*** SUMMARY ***
Total pot 250 | Rake 0 
Board [9d Kc Ad]
Seat 1: CARDBURR folded before Flop (didn't bet)
Seat 2: HSagerbaf collected (250)
Seat 3: Taargeett folded before Flop (didn't bet)
Seat 4: Gilmar735 folded before Flop (didn't bet)
Seat 5: timetrvlr folded before Flop (didn't bet)
Seat 6: PhxdB420 (button) folded before Flop (didn't bet)
Seat 7: IKE67701 (small blind) folded before Flop
Seat 8: concorddeadi (big blind) folded on the Flop
Seat 9: BDSattva folded before Flop (didn't bet)



PokerStars Hand #201497003860: Tournament #2632284264, 17000+3000 Hold'em No Limit - Level IV (50/100) - 2019/06/17 21:55:11 ET
Table '2632284264 3' 9-max Seat #7 is the button
Seat 1: CARDBURR (1365 in chips) 
Seat 2: HSagerbaf (3034 in chips) 
Seat 3: Taargeett (3570 in chips) 
Seat 4: Gilmar735 (4806 in chips) 
Seat 5: timetrvlr (1035 in chips) 
Seat 6: PhxdB420 (1207 in chips) 
Seat 7: IKE67701 (780 in chips) 
Seat 8: concorddeadi (2623 in chips) 
Seat 9: BDSattva (1700 in chips) 
concorddeadi: posts small blind 50
BDSattva: posts big blind 100
*** HOLE CARDS ***
Dealt to Taargeett [2s 6d]
CARDBURR: folds 
HSagerbaf: folds 
Taargeett: folds 
Gilmar735: folds 
timetrvlr: folds 
PhxdB420: folds 
IKE67701: folds 
concorddeadi: folds 
Uncalled bet (50) returned to BDSattva
BDSattva collected 100 from pot
*** SUMMARY ***
Total pot 100 | Rake 0 
Seat 1: CARDBURR folded before Flop (didn't bet)
Seat 2: HSagerbaf folded before Flop (didn't bet)
Seat 3: Taargeett folded before Flop (didn't bet)
Seat 4: Gilmar735 folded before Flop (didn't bet)
Seat 5: timetrvlr folded before Flop (didn't bet)
Seat 6: PhxdB420 folded before Flop (didn't bet)
Seat 7: IKE67701 (button) folded before Flop (didn't bet)
Seat 8: concorddeadi (small blind) folded before Flop
Seat 9: BDSattva (big blind) collected (100)



PokerStars Hand #201497007963: Tournament #2632284264, 17000+3000 Hold'em No Limit - Level IV (50/100) - 2019/06/17 21:55:30 ET
Table '2632284264 3' 9-max Seat #8 is the button
Seat 1: CARDBURR (1365 in chips) 
Seat 2: HSagerbaf (3034 in chips) 
Seat 3: Taargeett (3570 in chips) 
Seat 4: Gilmar735 (4806 in chips) 
Seat 5: timetrvlr (1035 in chips) 
Seat 6: PhxdB420 (1207 in chips) 
Seat 7: IKE67701 (780 in chips) 
Seat 8: concorddeadi (2573 in chips) 
Seat 9: BDSattva (1750 in chips) 
BDSattva: posts small blind 50
CARDBURR: posts big blind 100
*** HOLE CARDS ***
Dealt to Taargeett [3h 8s]
HSagerbaf: folds 
Taargeett: folds 
Gilmar735: folds 
timetrvlr: calls 100
PhxdB420: folds 
IKE67701: folds 
concorddeadi: folds 
BDSattva: calls 50
CARDBURR: checks 
*** FLOP *** [9d 2s Kc]
BDSattva: checks 
CARDBURR: checks 
timetrvlr: checks 
*** TURN *** [9d 2s Kc] [7h]
BDSattva: bets 300
CARDBURR: folds 
timetrvlr: calls 300
*** RIVER *** [9d 2s Kc 7h] [Th]
BDSattva: bets 700
timetrvlr: folds 
Uncalled bet (700) returned to BDSattva
BDSattva collected 900 from pot
*** SUMMARY ***
Total pot 900 | Rake 0 
Board [9d 2s Kc 7h Th]
Seat 1: CARDBURR (big blind) folded on the Turn
Seat 2: HSagerbaf folded before Flop (didn't bet)
Seat 3: Taargeett folded before Flop (didn't bet)
Seat 4: Gilmar735 folded before Flop (didn't bet)
Seat 5: timetrvlr folded on the River
Seat 6: PhxdB420 folded before Flop (didn't bet)
Seat 7: IKE67701 folded before Flop (didn't bet)
Seat 8: concorddeadi (button) folded before Flop (didn't bet)
Seat 9: BDSattva (small blind) collected (900)



PokerStars Hand #201497018687: Tournament #2632284264, 17000+3000 Hold'em No Limit - Level IV (50/100) - 2019/06/17 21:56:20 ET
Table '2632284264 3' 9-max Seat #9 is the button
Seat 1: CARDBURR (1265 in chips) 
Seat 2: HSagerbaf (3034 in chips) 
Seat 3: Taargeett (3570 in chips) 
Seat 4: Gilmar735 (4806 in chips) 
Seat 5: timetrvlr (635 in chips) 
Seat 6: PhxdB420 (1207 in chips) 
Seat 7: IKE67701 (780 in chips) 
Seat 8: concorddeadi (2573 in chips) 
Seat 9: BDSattva (2250 in chips) 
CARDBURR: posts small blind 50
HSagerbaf: posts big blind 100
*** HOLE CARDS ***
Dealt to Taargeett [7s Jh]
Taargeett: folds 
Gilmar735: folds 
timetrvlr: calls 100
PhxdB420: folds 
IKE67701: folds 
concorddeadi: calls 100
BDSattva: calls 100
CARDBURR: calls 50
HSagerbaf: checks 
*** FLOP *** [4h 6h 6d]
CARDBURR: checks 
HSagerbaf: checks 
timetrvlr: checks 
concorddeadi: checks 
BDSattva: checks 
*** TURN *** [4h 6h 6d] [Ad]
CARDBURR: checks 
HSagerbaf: checks 
timetrvlr: checks 
concorddeadi: bets 100
BDSattva: folds 
CARDBURR: calls 100
HSagerbaf: calls 100
timetrvlr: folds 
*** RIVER *** [4h 6h 6d Ad] [Qs]
CARDBURR: bets 800
HSagerbaf: folds 
concorddeadi: calls 800
*** SHOW DOWN ***
CARDBURR: shows [As Td] (two pair, Aces and Sixes)
concorddeadi: shows [Ah Jd] (two pair, Aces and Sixes)
CARDBURR collected 1200 from pot
concorddeadi collected 1200 from pot
*** SUMMARY ***
Total pot 2400 | Rake 0 
Board [4h 6h 6d Ad Qs]
Seat 1: CARDBURR (small blind) showed [As Td] and won (1200) with two pair, Aces and Sixes
Seat 2: HSagerbaf (big blind) folded on the River
Seat 3: Taargeett folded before Flop (didn't bet)
Seat 4: Gilmar735 folded before Flop (didn't bet)
Seat 5: timetrvlr folded on the Turn
Seat 6: PhxdB420 folded before Flop (didn't bet)
Seat 7: IKE67701 folded before Flop (didn't bet)
Seat 8: concorddeadi showed [Ah Jd] and won (1200) with two pair, Aces and Sixes
Seat 9: BDSattva (button) folded on the Turn



PokerStars Hand #201497031432: Tournament #2632284264, 17000+3000 Hold'em No Limit - Level IV (50/100) - 2019/06/17 21:57:20 ET
Table '2632284264 3' 9-max Seat #1 is the button
Seat 1: CARDBURR (1465 in chips) 
Seat 2: HSagerbaf (2834 in chips) 
Seat 3: Taargeett (3570 in chips) 
Seat 4: Gilmar735 (4806 in chips) 
Seat 5: timetrvlr (535 in chips) 
Seat 6: PhxdB420 (1207 in chips) 
Seat 7: IKE67701 (780 in chips) 
Seat 8: concorddeadi (2773 in chips) 
Seat 9: BDSattva (2150 in chips) 
HSagerbaf: posts small blind 50
Taargeett: posts big blind 100
*** HOLE CARDS ***
Dealt to Taargeett [2c 2h]
Gilmar735: folds 
timetrvlr: calls 100
PhxdB420: folds 
IKE67701: folds 
concorddeadi: folds 
BDSattva: calls 100
CARDBURR: folds 
HSagerbaf: calls 50
Taargeett: checks 
*** FLOP *** [4s As Kd]
HSagerbaf: checks 
Taargeett: checks 
timetrvlr: checks 
BDSattva: bets 200
HSagerbaf: folds 
Taargeett: folds 
timetrvlr: folds 
Uncalled bet (200) returned to BDSattva
BDSattva collected 400 from pot
*** SUMMARY ***
Total pot 400 | Rake 0 
Board [4s As Kd]
Seat 1: CARDBURR (button) folded before Flop (didn't bet)
Seat 2: HSagerbaf (small blind) folded on the Flop
Seat 3: Taargeett (big blind) folded on the Flop
Seat 4: Gilmar735 folded before Flop (didn't bet)
Seat 5: timetrvlr folded on the Flop
Seat 6: PhxdB420 folded before Flop (didn't bet)
Seat 7: IKE67701 folded before Flop (didn't bet)
Seat 8: concorddeadi folded before Flop (didn't bet)
Seat 9: BDSattva collected (400)



PokerStars Hand #201497039948: Tournament #2632284264, 17000+3000 Hold'em No Limit - Level IV (50/100) - 2019/06/17 21:58:00 ET
Table '2632284264 3' 9-max Seat #2 is the button
Seat 1: CARDBURR (1465 in chips) 
Seat 2: HSagerbaf (2734 in chips) 
Seat 3: Taargeett (3470 in chips) 
Seat 4: Gilmar735 (4806 in chips) 
Seat 5: timetrvlr (435 in chips) 
Seat 6: PhxdB420 (1207 in chips) 
Seat 7: IKE67701 (780 in chips) 
Seat 9: BDSattva (2450 in chips) 
Taargeett: posts small blind 50
Gilmar735: posts big blind 100
*** HOLE CARDS ***
Dealt to Taargeett [Td 9s]
timetrvlr: folds 
PhxdB420: folds 
IKE67701: folds 
BDSattva: raises 100 to 200
CARDBURR: folds 
HSagerbaf: folds 
Taargeett: folds 
Gilmar735: calls 100
*** FLOP *** [6s Ah Kc]
Gilmar735: checks 
BDSattva: bets 225
Gilmar735: folds 
Uncalled bet (225) returned to BDSattva
BDSattva collected 450 from pot
*** SUMMARY ***
Total pot 450 | Rake 0 
Board [6s Ah Kc]
Seat 1: CARDBURR folded before Flop (didn't bet)
Seat 2: HSagerbaf (button) folded before Flop (didn't bet)
Seat 3: Taargeett (small blind) folded before Flop
Seat 4: Gilmar735 (big blind) folded on the Flop
Seat 5: timetrvlr folded before Flop (didn't bet)
Seat 6: PhxdB420 folded before Flop (didn't bet)
Seat 7: IKE67701 folded before Flop (didn't bet)
Seat 9: BDSattva collected (450)



PokerStars Hand #201497045312: Tournament #2632284264, 17000+3000 Hold'em No Limit - Level IV (50/100) - 2019/06/17 21:58:25 ET
Table '2632284264 3' 9-max Seat #3 is the button
Seat 1: CARDBURR (1465 in chips) 
Seat 2: HSagerbaf (2734 in chips) 
Seat 3: Taargeett (3420 in chips) 
Seat 4: Gilmar735 (4606 in chips) 
Seat 5: timetrvlr (435 in chips) 
Seat 6: PhxdB420 (1207 in chips) 
Seat 7: IKE67701 (780 in chips) 
Seat 9: BDSattva (2700 in chips) 
Gilmar735: posts small blind 50
timetrvlr: posts big blind 100
*** HOLE CARDS ***
Dealt to Taargeett [4h Qh]
PhxdB420: raises 200 to 300
IKE67701: folds 
BDSattva: folds 
CARDBURR: folds 
HSagerbaf: folds 
Taargeett: raises 200 to 500
Gilmar735: folds 
timetrvlr: folds 
PhxdB420: calls 200
*** FLOP *** [2h Kd Tc]
PhxdB420: checks 
Taargeett: bets 400
PhxdB420: calls 400
*** TURN *** [2h Kd Tc] [Ks]
PhxdB420: bets 307 and is all-in
Taargeett: folds 
Uncalled bet (307) returned to PhxdB420
PhxdB420 collected 1950 from pot
PhxdB420: doesn't show hand 
*** SUMMARY ***
Total pot 1950 | Rake 0 
Board [2h Kd Tc Ks]
Seat 1: CARDBURR folded before Flop (didn't bet)
Seat 2: HSagerbaf folded before Flop (didn't bet)
Seat 3: Taargeett (button) folded on the Turn
Seat 4: Gilmar735 (small blind) folded before Flop
Seat 5: timetrvlr (big blind) folded before Flop
Seat 6: PhxdB420 collected (1950)
Seat 7: IKE67701 folded before Flop (didn't bet)
Seat 9: BDSattva folded before Flop (didn't bet)



PokerStars Hand #201497054571: Tournament #2632284264, 17000+3000 Hold'em No Limit - Level V (75/150) - 2019/06/17 21:59:08 ET
Table '2632284264 3' 9-max Seat #4 is the button
Seat 1: CARDBURR (1465 in chips) 
Seat 2: HSagerbaf (2734 in chips) 
Seat 3: Taargeett (2520 in chips) 
Seat 4: Gilmar735 (4556 in chips) 
Seat 5: timetrvlr (335 in chips) 
Seat 6: PhxdB420 (2257 in chips) 
Seat 7: IKE67701 (780 in chips) 
Seat 9: BDSattva (2700 in chips) 
timetrvlr: posts small blind 75
PhxdB420: posts big blind 150
*** HOLE CARDS ***
Dealt to Taargeett [7c Qd]
IKE67701: folds 
BDSattva: folds 
CARDBURR: folds 
HSagerbaf: folds 
Taargeett: folds 
Gilmar735: folds 
timetrvlr: folds 
Uncalled bet (75) returned to PhxdB420
PhxdB420 collected 150 from pot
PhxdB420: doesn't show hand 
*** SUMMARY ***
Total pot 150 | Rake 0 
Seat 1: CARDBURR folded before Flop (didn't bet)
Seat 2: HSagerbaf folded before Flop (didn't bet)
Seat 3: Taargeett folded before Flop (didn't bet)
Seat 4: Gilmar735 (button) folded before Flop (didn't bet)
Seat 5: timetrvlr (small blind) folded before Flop
Seat 6: PhxdB420 (big blind) collected (150)
Seat 7: IKE67701 folded before Flop (didn't bet)
Seat 9: BDSattva folded before Flop (didn't bet)



PokerStars Hand #201497058490: Tournament #2632284264, 17000+3000 Hold'em No Limit - Level V (75/150) - 2019/06/17 21:59:27 ET
Table '2632284264 3' 9-max Seat #5 is the button
Seat 1: CARDBURR (1465 in chips) 
Seat 2: HSagerbaf (2734 in chips) 
Seat 3: Taargeett (2520 in chips) 
Seat 4: Gilmar735 (4556 in chips) 
Seat 5: timetrvlr (260 in chips) 
Seat 6: PhxdB420 (2332 in chips) 
Seat 7: IKE67701 (780 in chips) 
Seat 9: BDSattva (2700 in chips) 
PhxdB420: posts small blind 75
IKE67701: posts big blind 150
*** HOLE CARDS ***
Dealt to Taargeett [Qs Ks]
BDSattva: folds 
CARDBURR: folds 
HSagerbaf: folds 
Taargeett: raises 150 to 300
Gilmar735: folds 
timetrvlr: calls 260 and is all-in
PhxdB420: folds 
IKE67701: folds 
Uncalled bet (40) returned to Taargeett
*** FLOP *** [5s 3s 3h]
*** TURN *** [5s 3s 3h] [Jh]
*** RIVER *** [5s 3s 3h Jh] [Th]
*** SHOW DOWN ***
Taargeett: shows [Qs Ks] (a pair of Threes)
timetrvlr: shows [As Qc] (a pair of Threes - Ace kicker)
timetrvlr collected 745 from pot
*** SUMMARY ***
Total pot 745 | Rake 0 
Board [5s 3s 3h Jh Th]
Seat 1: CARDBURR folded before Flop (didn't bet)
Seat 2: HSagerbaf folded before Flop (didn't bet)
Seat 3: Taargeett showed [Qs Ks] and lost with a pair of Threes
Seat 4: Gilmar735 folded before Flop (didn't bet)
Seat 5: timetrvlr (button) showed [As Qc] and won (745) with a pair of Threes
Seat 6: PhxdB420 (small blind) folded before Flop
Seat 7: IKE67701 (big blind) folded before Flop
Seat 9: BDSattva folded before Flop (didn't bet)



PokerStars Hand #201497063608: Tournament #2632284264, 17000+3000 Hold'em No Limit - Level V (75/150) - 2019/06/17 21:59:51 ET
Table '2632284264 3' 9-max Seat #6 is the button
Seat 1: CARDBURR (1465 in chips) 
Seat 2: HSagerbaf (2734 in chips) 
Seat 3: Taargeett (2260 in chips) 
Seat 4: Gilmar735 (4556 in chips) 
Seat 5: timetrvlr (745 in chips) 
Seat 6: PhxdB420 (2257 in chips) 
Seat 7: IKE67701 (630 in chips) 
Seat 9: BDSattva (2700 in chips) 
IKE67701: posts small blind 75
BDSattva: posts big blind 150
*** HOLE CARDS ***
Dealt to Taargeett [7c Kc]
CARDBURR: calls 150
HSagerbaf: raises 150 to 300
Taargeett: folds 
Gilmar735: folds 
timetrvlr: folds 
PhxdB420: calls 300
IKE67701: folds 
BDSattva: folds 
CARDBURR: calls 150
*** FLOP *** [8d Qh 3h]
CARDBURR: checks 
HSagerbaf: bets 150
PhxdB420: calls 150
CARDBURR: folds 
*** TURN *** [8d Qh 3h] [9c]
HSagerbaf: bets 150
PhxdB420: calls 150
*** RIVER *** [8d Qh 3h 9c] [4d]
HSagerbaf: bets 150
PhxdB420: calls 150
*** SHOW DOWN ***
HSagerbaf: shows [Kd As] (high card Ace)
PhxdB420: shows [9s Ah] (a pair of Nines)
PhxdB420 collected 2025 from pot
*** SUMMARY ***
Total pot 2025 | Rake 0 
Board [8d Qh 3h 9c 4d]
Seat 1: CARDBURR folded on the Flop
Seat 2: HSagerbaf showed [Kd As] and lost with high card Ace
Seat 3: Taargeett folded before Flop (didn't bet)
Seat 4: Gilmar735 folded before Flop (didn't bet)
Seat 5: timetrvlr folded before Flop (didn't bet)
Seat 6: PhxdB420 (button) showed [9s Ah] and won (2025) with a pair of Nines
Seat 7: IKE67701 (small blind) folded before Flop
Seat 9: BDSattva (big blind) folded before Flop



PokerStars Hand #201497073103: Tournament #2632284264, 17000+3000 Hold'em No Limit - Level V (75/150) - 2019/06/17 22:00:35 ET
Table '2632284264 3' 9-max Seat #7 is the button
Seat 1: CARDBURR (1165 in chips) 
Seat 2: HSagerbaf (1984 in chips) 
Seat 3: Taargeett (2260 in chips) 
Seat 4: Gilmar735 (4556 in chips) 
Seat 5: timetrvlr (745 in chips) 
Seat 6: PhxdB420 (3532 in chips) 
Seat 7: IKE67701 (555 in chips) 
Seat 9: BDSattva (2550 in chips) 
BDSattva: posts small blind 75
CARDBURR: posts big blind 150
*** HOLE CARDS ***
Dealt to Taargeett [7s 2c]
HSagerbaf: folds 
Taargeett: folds 
Gilmar735: folds 
timetrvlr: folds 
PhxdB420: raises 300 to 450
IKE67701: raises 105 to 555 and is all-in
BDSattva: folds 
CARDBURR: folds 
PhxdB420: calls 105
*** FLOP *** [3h 8d Ad]
*** TURN *** [3h 8d Ad] [Qd]
*** RIVER *** [3h 8d Ad Qd] [8s]
*** SHOW DOWN ***
PhxdB420: shows [9c Tc] (a pair of Eights)
IKE67701: shows [Kh Td] (a pair of Eights - Ace+King kicker)
IKE67701 collected 1335 from pot
*** SUMMARY ***
Total pot 1335 | Rake 0 
Board [3h 8d Ad Qd 8s]
Seat 1: CARDBURR (big blind) folded before Flop
Seat 2: HSagerbaf folded before Flop (didn't bet)
Seat 3: Taargeett folded before Flop (didn't bet)
Seat 4: Gilmar735 folded before Flop (didn't bet)
Seat 5: timetrvlr folded before Flop (didn't bet)
Seat 6: PhxdB420 showed [9c Tc] and lost with a pair of Eights
Seat 7: IKE67701 (button) showed [Kh Td] and won (1335) with a pair of Eights
Seat 9: BDSattva (small blind) folded before Flop



PokerStars Hand #201497081079: Tournament #2632284264, 17000+3000 Hold'em No Limit - Level V (75/150) - 2019/06/17 22:01:09 ET
Table '2632284264 3' 9-max Seat #9 is the button
Seat 1: CARDBURR (1015 in chips) 
Seat 2: HSagerbaf (1984 in chips) 
Seat 3: Taargeett (2260 in chips) 
Seat 4: Gilmar735 (4556 in chips) 
Seat 5: timetrvlr (745 in chips) 
Seat 6: PhxdB420 (2977 in chips) 
Seat 7: IKE67701 (1335 in chips) 
Seat 9: BDSattva (2475 in chips) 
CARDBURR: posts small blind 75
HSagerbaf: posts big blind 150
*** HOLE CARDS ***
Dealt to Taargeett [7c 5h]
Taargeett: folds 
Gilmar735: folds 
timetrvlr: calls 150
PhxdB420: calls 150
IKE67701: folds 
BDSattva: calls 150
CARDBURR: calls 75
HSagerbaf: checks 
*** FLOP *** [8s 6s 3c]
CARDBURR: checks 
HSagerbaf: bets 1834 and is all-in
timetrvlr: calls 595 and is all-in
PhxdB420: folds 
BDSattva: calls 1834
CARDBURR: folds 
*** TURN *** [8s 6s 3c] [Qc]
*** RIVER *** [8s 6s 3c Qc] [Qs]
*** SHOW DOWN ***
HSagerbaf: shows [6d 8d] (two pair, Queens and Eights)
BDSattva: shows [3d 3h] (a full house, Threes full of Queens)
BDSattva collected 2478 from side pot
timetrvlr: shows [9s 9h] (two pair, Queens and Nines)
BDSattva collected 2535 from main pot
HSagerbaf finished the tournament in 29th place
timetrvlr finished the tournament in 30th place
*** SUMMARY ***
Total pot 5013 Main pot 2535. Side pot 2478. | Rake 0 
Board [8s 6s 3c Qc Qs]
Seat 1: CARDBURR (small blind) folded on the Flop
Seat 2: HSagerbaf (big blind) showed [6d 8d] and lost with two pair, Queens and Eights
Seat 3: Taargeett folded before Flop (didn't bet)
Seat 4: Gilmar735 folded before Flop (didn't bet)
Seat 5: timetrvlr showed [9s 9h] and lost with two pair, Queens and Nines
Seat 6: PhxdB420 folded on the Flop
Seat 7: IKE67701 folded before Flop (didn't bet)
Seat 9: BDSattva (button) showed [3d 3h] and won (5013) with a full house, Threes full of Queens



PokerStars Hand #201497092171: Tournament #2632284264, 17000+3000 Hold'em No Limit - Level V (75/150) - 2019/06/17 22:01:54 ET
Table '2632284264 3' 9-max Seat #1 is the button
Seat 1: CARDBURR (865 in chips) 
Seat 3: Taargeett (2260 in chips) 
Seat 4: Gilmar735 (4556 in chips) 
Seat 6: PhxdB420 (2827 in chips) 
Seat 7: IKE67701 (1335 in chips) 
Seat 9: BDSattva (5504 in chips) 
Taargeett: posts small blind 75
Gilmar735: posts big blind 150
*** HOLE CARDS ***
Dealt to Taargeett [4c Ts]
PhxdB420: folds 
IKE67701: folds 
BDSattva: calls 150
CARDBURR: folds 
Taargeett: folds 
Gilmar735: checks 
*** FLOP *** [5d Qh 3d]
Gilmar735: bets 150
BDSattva: folds 
Uncalled bet (150) returned to Gilmar735
Gilmar735 collected 375 from pot
*** SUMMARY ***
Total pot 375 | Rake 0 
Board [5d Qh 3d]
Seat 1: CARDBURR (button) folded before Flop (didn't bet)
Seat 3: Taargeett (small blind) folded before Flop
Seat 4: Gilmar735 (big blind) collected (375)
Seat 6: PhxdB420 folded before Flop (didn't bet)
Seat 7: IKE67701 folded before Flop (didn't bet)
Seat 9: BDSattva folded on the Flop



PokerStars Hand #201497099153: Tournament #2632284264, 17000+3000 Hold'em No Limit - Level V (75/150) - 2019/06/17 22:02:22 ET
Table '2632284264 3' 9-max Seat #3 is the button
Seat 1: CARDBURR (865 in chips) 
Seat 3: Taargeett (2185 in chips) 
Seat 4: Gilmar735 (4781 in chips) 
Seat 6: PhxdB420 (2827 in chips) 
Seat 7: IKE67701 (1335 in chips) 
Seat 9: BDSattva (5354 in chips) 
Gilmar735: posts small blind 75
PhxdB420: posts big blind 150
*** HOLE CARDS ***
Dealt to Taargeett [4d Ks]
IKE67701: folds 
BDSattva: raises 300 to 450
CARDBURR: folds 
Taargeett: folds 
Gilmar735: folds 
PhxdB420: calls 300
*** FLOP *** [Qh 6s 5c]
PhxdB420: checks 
BDSattva: bets 488
PhxdB420: calls 488
*** TURN *** [Qh 6s 5c] [7s]
PhxdB420: checks 
BDSattva: bets 976
PhxdB420: calls 976
*** RIVER *** [Qh 6s 5c 7s] [2c]
PhxdB420: checks 
BDSattva: checks 
*** SHOW DOWN ***
PhxdB420: shows [9s 8d] (a straight, Five to Nine)
BDSattva: mucks hand 
PhxdB420 collected 3903 from pot
*** SUMMARY ***
Total pot 3903 | Rake 0 
Board [Qh 6s 5c 7s 2c]
Seat 1: CARDBURR folded before Flop (didn't bet)
Seat 3: Taargeett (button) folded before Flop (didn't bet)
Seat 4: Gilmar735 (small blind) folded before Flop
Seat 6: PhxdB420 (big blind) showed [9s 8d] and won (3903) with a straight, Five to Nine
Seat 7: IKE67701 folded before Flop (didn't bet)
Seat 9: BDSattva mucked [Th Ts]



PokerStars Hand #201497112578: Tournament #2632284264, 17000+3000 Hold'em No Limit - Level V (75/150) - 2019/06/17 22:03:15 ET
Table '2632284264 3' 9-max Seat #4 is the button
Seat 1: CARDBURR (865 in chips) 
Seat 2: BAD BRAZZ 2424 (810 in chips) is sitting out
Seat 3: Taargeett (2185 in chips) 
Seat 4: Gilmar735 (4706 in chips) 
Seat 5: Chico25or624 (1335 in chips) out of hand (moved from another table into small blind)
Seat 6: PhxdB420 (4816 in chips) 
Seat 7: IKE67701 (1335 in chips) 
Seat 8: Kishan01 (3150 in chips) 
Seat 9: BDSattva (3440 in chips) 
Chico25or624 will be allowed to play after the button
PhxdB420: posts small blind 75
IKE67701: posts big blind 150
*** HOLE CARDS ***
Dealt to Taargeett [6c Ad]
Kishan01: folds 
BDSattva: calls 150
CARDBURR: calls 150
BAD BRAZZ 2424: folds 
Taargeett: folds 
Gilmar735: folds 
PhxdB420: folds 
IKE67701: checks 
*** FLOP *** [5d 8c 6h]
IKE67701: bets 150
BDSattva: calls 150
CARDBURR: folds 
*** TURN *** [5d 8c 6h] [4h]
IKE67701: bets 150
BDSattva: calls 150
*** RIVER *** [5d 8c 6h 4h] [5c]
IKE67701: bets 150
BDSattva: folds 
Uncalled bet (150) returned to IKE67701
IKE67701 collected 1125 from pot
IKE67701: doesn't show hand 
*** SUMMARY ***
Total pot 1125 | Rake 0 
Board [5d 8c 6h 4h 5c]
Seat 1: CARDBURR folded on the Flop
Seat 2: BAD BRAZZ 2424 folded before Flop (didn't bet)
Seat 3: Taargeett folded before Flop (didn't bet)
Seat 4: Gilmar735 (button) folded before Flop (didn't bet)
Seat 6: PhxdB420 (small blind) folded before Flop
Seat 7: IKE67701 (big blind) collected (1125)
Seat 8: Kishan01 folded before Flop (didn't bet)
Seat 9: BDSattva folded on the River



PokerStars Hand #201497123788: Tournament #2632284264, 17000+3000 Hold'em No Limit - Level VI (100/200) - 2019/06/17 22:03:59 ET
Table '2632284264 3' 9-max Seat #6 is the button
Seat 1: CARDBURR (715 in chips) 
Seat 2: BAD BRAZZ 2424 (810 in chips) is sitting out
Seat 3: Taargeett (2185 in chips) 
Seat 4: Gilmar735 (4706 in chips) 
Seat 5: Chico25or624 (1335 in chips) 
Seat 6: PhxdB420 (4741 in chips) 
Seat 7: IKE67701 (2010 in chips) 
Seat 8: Kishan01 (3150 in chips) 
Seat 9: BDSattva (2990 in chips) 
IKE67701: posts small blind 100
Kishan01: posts big blind 200
*** HOLE CARDS ***
Dealt to Taargeett [3c 8d]
BDSattva: folds 
CARDBURR: folds 
BAD BRAZZ 2424: folds 
Taargeett: folds 
Gilmar735 has timed out
Gilmar735: folds 
Chico25or624: folds 
PhxdB420: raises 400 to 600
IKE67701: folds 
Kishan01: folds 
Uncalled bet (400) returned to PhxdB420
PhxdB420 collected 500 from pot
PhxdB420: doesn't show hand 
*** SUMMARY ***
Total pot 500 | Rake 0 
Seat 1: CARDBURR folded before Flop (didn't bet)
Seat 2: BAD BRAZZ 2424 folded before Flop (didn't bet)
Seat 3: Taargeett folded before Flop (didn't bet)
Seat 4: Gilmar735 folded before Flop (didn't bet)
Seat 5: Chico25or624 folded before Flop (didn't bet)
Seat 6: PhxdB420 (button) collected (500)
Seat 7: IKE67701 (small blind) folded before Flop
Seat 8: Kishan01 (big blind) folded before Flop
Seat 9: BDSattva folded before Flop (didn't bet)



PokerStars Hand #201497135309: Tournament #2632284264, 17000+3000 Hold'em No Limit - Level VI (100/200) - 2019/06/17 22:04:44 ET
Table '2632284264 3' 9-max Seat #7 is the button
Seat 1: CARDBURR (715 in chips) 
Seat 2: BAD BRAZZ 2424 (810 in chips) is sitting out
Seat 3: Taargeett (2185 in chips) 
Seat 4: Gilmar735 (4706 in chips) 
Seat 5: Chico25or624 (1335 in chips) 
Seat 6: PhxdB420 (5041 in chips) 
Seat 7: IKE67701 (1910 in chips) 
Seat 8: Kishan01 (2950 in chips) 
Seat 9: BDSattva (2990 in chips) 
Kishan01: posts small blind 100
BDSattva: posts big blind 200
*** HOLE CARDS ***
Dealt to Taargeett [5s 8c]
CARDBURR: folds 
BAD BRAZZ 2424: folds 
Taargeett: folds 
Gilmar735: folds 
Chico25or624: raises 200 to 400
PhxdB420: folds 
IKE67701: calls 400
Kishan01: folds 
BDSattva: calls 200
*** FLOP *** [Jd 8h 4s]
BDSattva: checks 
Chico25or624: bets 935 and is all-in
IKE67701: calls 935
BDSattva: folds 
*** TURN *** [Jd 8h 4s] [5d]
*** RIVER *** [Jd 8h 4s 5d] [Kd]
*** SHOW DOWN ***
Chico25or624: shows [8s Ah] (a pair of Eights)
IKE67701: shows [Jh As] (a pair of Jacks)
IKE67701 collected 3170 from pot
Chico25or624 finished the tournament in 26th place
*** SUMMARY ***
Total pot 3170 | Rake 0 
Board [Jd 8h 4s 5d Kd]
Seat 1: CARDBURR folded before Flop (didn't bet)
Seat 2: BAD BRAZZ 2424 folded before Flop (didn't bet)
Seat 3: Taargeett folded before Flop (didn't bet)
Seat 4: Gilmar735 folded before Flop (didn't bet)
Seat 5: Chico25or624 showed [8s Ah] and lost with a pair of Eights
Seat 6: PhxdB420 folded before Flop (didn't bet)
Seat 7: IKE67701 (button) showed [Jh As] and won (3170) with a pair of Jacks
Seat 8: Kishan01 (small blind) folded before Flop
Seat 9: BDSattva (big blind) folded on the Flop



PokerStars Hand #201497144860: Tournament #2632284264, 17000+3000 Hold'em No Limit - Level VI (100/200) - 2019/06/17 22:05:21 ET
Table '2632284264 3' 9-max Seat #8 is the button
Seat 1: CARDBURR (715 in chips) 
Seat 2: BAD BRAZZ 2424 (810 in chips) is sitting out
Seat 3: Taargeett (2185 in chips) 
Seat 4: Gilmar735 (4706 in chips) 
Seat 6: PhxdB420 (5041 in chips) 
Seat 7: IKE67701 (3745 in chips) 
Seat 8: Kishan01 (2850 in chips) 
Seat 9: BDSattva (2590 in chips) 
BDSattva: posts small blind 100
CARDBURR: posts big blind 200
*** HOLE CARDS ***
Dealt to Taargeett [7d Ac]
BAD BRAZZ 2424: folds 
Taargeett: folds 
Gilmar735: folds 
PhxdB420: raises 400 to 600
IKE67701: calls 600
Kishan01: folds 
BDSattva: folds 
CARDBURR: calls 400
*** FLOP *** [Kc Ks 6s]
CARDBURR: bets 115 and is all-in
PhxdB420: calls 115
IKE67701: folds 
*** TURN *** [Kc Ks 6s] [Qd]
*** RIVER *** [Kc Ks 6s Qd] [6c]
*** SHOW DOWN ***
CARDBURR: shows [4h 4c] (two pair, Kings and Sixes)
PhxdB420: shows [3c As] (two pair, Kings and Sixes - Ace kicker)
PhxdB420 collected 2130 from pot
CARDBURR finished the tournament in 25th place
*** SUMMARY ***
Total pot 2130 | Rake 0 
Board [Kc Ks 6s Qd 6c]
Seat 1: CARDBURR (big blind) showed [4h 4c] and lost with two pair, Kings and Sixes
Seat 2: BAD BRAZZ 2424 folded before Flop (didn't bet)
Seat 3: Taargeett folded before Flop (didn't bet)
Seat 4: Gilmar735 folded before Flop (didn't bet)
Seat 6: PhxdB420 showed [3c As] and won (2130) with two pair, Kings and Sixes
Seat 7: IKE67701 folded on the Flop
Seat 8: Kishan01 (button) folded before Flop (didn't bet)
Seat 9: BDSattva (small blind) folded before Flop



PokerStars Hand #201497157253: Tournament #2632284264, 17000+3000 Hold'em No Limit - Level VI (100/200) - 2019/06/17 22:06:10 ET
Table '2632284264 3' 9-max Seat #9 is the button
Seat 2: BAD BRAZZ 2424 (810 in chips) is sitting out
Seat 3: Taargeett (2185 in chips) 
Seat 4: Gilmar735 (4706 in chips) 
Seat 6: PhxdB420 (6456 in chips) 
Seat 7: IKE67701 (3145 in chips) 
Seat 8: Kishan01 (2850 in chips) 
Seat 9: BDSattva (2490 in chips) 
BAD BRAZZ 2424: posts small blind 100
Taargeett: posts big blind 200
*** HOLE CARDS ***
Dealt to Taargeett [4c 2c]
Gilmar735: folds 
PhxdB420: folds 
IKE67701: calls 200
Kishan01: folds 
BDSattva: folds 
BAD BRAZZ 2424: folds 
Taargeett: checks 
*** FLOP *** [Ts 8s Kd]
Taargeett: checks 
IKE67701: checks 
*** TURN *** [Ts 8s Kd] [3c]
Taargeett: checks 
IKE67701: checks 
*** RIVER *** [Ts 8s Kd 3c] [4s]
Taargeett: bets 500
IKE67701: calls 500
*** SHOW DOWN ***
Taargeett: shows [4c 2c] (a pair of Fours)
IKE67701: mucks hand 
Taargeett collected 1500 from pot
*** SUMMARY ***
Total pot 1500 | Rake 0 
Board [Ts 8s Kd 3c 4s]
Seat 2: BAD BRAZZ 2424 (small blind) folded before Flop
Seat 3: Taargeett (big blind) showed [4c 2c] and won (1500) with a pair of Fours
Seat 4: Gilmar735 folded before Flop (didn't bet)
Seat 6: PhxdB420 folded before Flop (didn't bet)
Seat 7: IKE67701 mucked [Ac 7s]
Seat 8: Kishan01 folded before Flop (didn't bet)
Seat 9: BDSattva (button) folded before Flop (didn't bet)



PokerStars Hand #201497170318: Tournament #2632284264, 17000+3000 Hold'em No Limit - Level VI (100/200) - 2019/06/17 22:07:02 ET
Table '2632284264 3' 9-max Seat #2 is the button
Seat 2: BAD BRAZZ 2424 (710 in chips) is sitting out
Seat 3: Taargeett (2985 in chips) 
Seat 4: Gilmar735 (4706 in chips) 
Seat 6: PhxdB420 (6456 in chips) 
Seat 7: IKE67701 (2445 in chips) 
Seat 8: Kishan01 (2850 in chips) 
Seat 9: BDSattva (2490 in chips) 
Taargeett: posts small blind 100
Gilmar735: posts big blind 200
*** HOLE CARDS ***
Dealt to Taargeett [4d Jc]
PhxdB420: calls 200
IKE67701: folds 
Kishan01: folds 
BDSattva: folds 
BAD BRAZZ 2424: folds 
Taargeett: folds 
Gilmar735: checks 
*** FLOP *** [Qs 2s Kc]
Gilmar735: checks 
PhxdB420: checks 
*** TURN *** [Qs 2s Kc] [7c]
Gilmar735: checks 
PhxdB420: checks 
*** RIVER *** [Qs 2s Kc 7c] [As]
Gilmar735: checks 
PhxdB420: checks 
*** SHOW DOWN ***
Gilmar735: shows [4c 6h] (high card Ace)
PhxdB420: shows [8d Td] (high card Ace - King+Queen+Ten kicker)
PhxdB420 collected 500 from pot
*** SUMMARY ***
Total pot 500 | Rake 0 
Board [Qs 2s Kc 7c As]
Seat 2: BAD BRAZZ 2424 (button) folded before Flop (didn't bet)
Seat 3: Taargeett (small blind) folded before Flop
Seat 4: Gilmar735 (big blind) showed [4c 6h] and lost with high card Ace
Seat 6: PhxdB420 showed [8d Td] and won (500) with high card Ace
Seat 7: IKE67701 folded before Flop (didn't bet)
Seat 8: Kishan01 folded before Flop (didn't bet)
Seat 9: BDSattva folded before Flop (didn't bet)



PokerStars Hand #201497185905: Tournament #2632284264, 17000+3000 Hold'em No Limit - Level VI (100/200) - 2019/06/17 22:08:04 ET
Table '2632284264 3' 9-max Seat #3 is the button
Seat 1: KingMosesTX (2885 in chips) 
Seat 3: Taargeett (2885 in chips) 
Seat 4: Gilmar735 (4506 in chips) 
Seat 6: PhxdB420 (6756 in chips) 
Seat 7: IKE67701 (2445 in chips) 
Seat 8: Kishan01 (2850 in chips) 
Seat 9: BDSattva (2490 in chips) 
Gilmar735: posts small blind 100
PhxdB420: posts big blind 200
*** HOLE CARDS ***
Dealt to Taargeett [2c 3h]
IKE67701: folds 
Kishan01: folds 
BDSattva: folds 
KingMosesTX: folds 
Taargeett: folds 
Gilmar735: raises 200 to 400
PhxdB420: folds 
Uncalled bet (200) returned to Gilmar735
Gilmar735 collected 400 from pot
*** SUMMARY ***
Total pot 400 | Rake 0 
Seat 1: KingMosesTX folded before Flop (didn't bet)
Seat 3: Taargeett (button) folded before Flop (didn't bet)
Seat 4: Gilmar735 (small blind) collected (400)
Seat 6: PhxdB420 (big blind) folded before Flop
Seat 7: IKE67701 folded before Flop (didn't bet)
Seat 8: Kishan01 folded before Flop (didn't bet)
Seat 9: BDSattva folded before Flop (didn't bet)



PokerStars Hand #201497193694: Tournament #2632284264, 17000+3000 Hold'em No Limit - Level VI (100/200) - 2019/06/17 22:08:36 ET
Table '2632284264 3' 9-max Seat #4 is the button
Seat 1: KingMosesTX (2885 in chips) 
Seat 3: Taargeett (2885 in chips) 
Seat 4: Gilmar735 (4706 in chips) 
Seat 6: PhxdB420 (6556 in chips) 
Seat 7: IKE67701 (2445 in chips) 
Seat 8: Kishan01 (2850 in chips) 
Seat 9: BDSattva (2490 in chips) 
PhxdB420: posts small blind 100
IKE67701: posts big blind 200
*** HOLE CARDS ***
Dealt to Taargeett [2s Kh]
Kishan01: folds 
BDSattva: raises 2290 to 2490 and is all-in
KingMosesTX: folds 
Taargeett: folds 
Gilmar735: folds 
PhxdB420: folds 
IKE67701: folds 
Uncalled bet (2290) returned to BDSattva
BDSattva collected 500 from pot
*** SUMMARY ***
Total pot 500 | Rake 0 
Seat 1: KingMosesTX folded before Flop (didn't bet)
Seat 3: Taargeett folded before Flop (didn't bet)
Seat 4: Gilmar735 (button) folded before Flop (didn't bet)
Seat 6: PhxdB420 (small blind) folded before Flop
Seat 7: IKE67701 (big blind) folded before Flop
Seat 8: Kishan01 folded before Flop (didn't bet)
Seat 9: BDSattva collected (500)



PokerStars Hand #201497198938: Tournament #2632284264, 17000+3000 Hold'em No Limit - Level VII (100/200) - 2019/06/17 22:08:57 ET
Table '2632284264 3' 9-max Seat #6 is the button
Seat 1: KingMosesTX (2885 in chips) 
Seat 3: Taargeett (2885 in chips) 
Seat 4: Gilmar735 (4706 in chips) 
Seat 6: PhxdB420 (6456 in chips) 
Seat 7: IKE67701 (2245 in chips) 
Seat 8: Kishan01 (2850 in chips) 
Seat 9: BDSattva (2790 in chips) 
KingMosesTX: posts the ante 25
Taargeett: posts the ante 25
Gilmar735: posts the ante 25
PhxdB420: posts the ante 25
IKE67701: posts the ante 25
Kishan01: posts the ante 25
BDSattva: posts the ante 25
IKE67701: posts small blind 100
Kishan01: posts big blind 200
*** HOLE CARDS ***
Dealt to Taargeett [4d 4h]
BDSattva: folds 
KingMosesTX: folds 
Taargeett: raises 200 to 400
Gilmar735: folds 
PhxdB420: folds 
IKE67701: folds 
Kishan01: folds 
Uncalled bet (200) returned to Taargeett
Taargeett collected 675 from pot
Taargeett: doesn't show hand 
*** SUMMARY ***
Total pot 675 | Rake 0 
Seat 1: KingMosesTX folded before Flop (didn't bet)
Seat 3: Taargeett collected (675)
Seat 4: Gilmar735 folded before Flop (didn't bet)
Seat 6: PhxdB420 (button) folded before Flop (didn't bet)
Seat 7: IKE67701 (small blind) folded before Flop
Seat 8: Kishan01 (big blind) folded before Flop
Seat 9: BDSattva folded before Flop (didn't bet)



PokerStars Hand #201497204961: Tournament #2632284264, 17000+3000 Hold'em No Limit - Level VII (100/200) - 2019/06/17 22:09:21 ET
Table '2632284264 3' 9-max Seat #7 is the button
Seat 1: KingMosesTX (2860 in chips) 
Seat 3: Taargeett (3335 in chips) 
Seat 4: Gilmar735 (4681 in chips) 
Seat 6: PhxdB420 (6431 in chips) 
Seat 7: IKE67701 (2120 in chips) 
Seat 8: Kishan01 (2625 in chips) 
Seat 9: BDSattva (2765 in chips) 
KingMosesTX: posts the ante 25
Taargeett: posts the ante 25
Gilmar735: posts the ante 25
PhxdB420: posts the ante 25
IKE67701: posts the ante 25
Kishan01: posts the ante 25
BDSattva: posts the ante 25
Kishan01: posts small blind 100
BDSattva: posts big blind 200
*** HOLE CARDS ***
Dealt to Taargeett [9h 8s]
KingMosesTX: folds 
Taargeett: folds 
Gilmar735: folds 
PhxdB420: folds 
IKE67701: folds 
Kishan01: raises 200 to 400
BDSattva: raises 2340 to 2740 and is all-in
Kishan01: folds 
Uncalled bet (2340) returned to BDSattva
BDSattva collected 975 from pot
*** SUMMARY ***
Total pot 975 | Rake 0 
Seat 1: KingMosesTX folded before Flop (didn't bet)
Seat 3: Taargeett folded before Flop (didn't bet)
Seat 4: Gilmar735 folded before Flop (didn't bet)
Seat 6: PhxdB420 folded before Flop (didn't bet)
Seat 7: IKE67701 (button) folded before Flop (didn't bet)
Seat 8: Kishan01 (small blind) folded before Flop
Seat 9: BDSattva (big blind) collected (975)



PokerStars Hand #201497215392: Tournament #2632284264, 17000+3000 Hold'em No Limit - Level VII (100/200) - 2019/06/17 22:10:03 ET
Table '2632284264 3' 9-max Seat #8 is the button
Seat 1: KingMosesTX (2835 in chips) 
Seat 3: Taargeett (3310 in chips) 
Seat 4: Gilmar735 (4656 in chips) 
Seat 6: PhxdB420 (6406 in chips) 
Seat 7: IKE67701 (2095 in chips) 
Seat 8: Kishan01 (2200 in chips) 
Seat 9: BDSattva (3315 in chips) 
KingMosesTX: posts the ante 25
Taargeett: posts the ante 25
Gilmar735: posts the ante 25
PhxdB420: posts the ante 25
IKE67701: posts the ante 25
Kishan01: posts the ante 25
BDSattva: posts the ante 25
BDSattva: posts small blind 100
KingMosesTX: posts big blind 200
*** HOLE CARDS ***
Dealt to Taargeett [5s Td]
Taargeett: folds 
Gilmar735: folds 
PhxdB420: folds 
IKE67701: calls 200
Kishan01: folds 
BDSattva: calls 100
KingMosesTX: checks 
*** FLOP *** [9s Kh Ad]
BDSattva: checks 
KingMosesTX: checks 
IKE67701: checks 
*** TURN *** [9s Kh Ad] [3c]
BDSattva: bets 388
KingMosesTX: folds 
IKE67701: calls 388
*** RIVER *** [9s Kh Ad 3c] [Qh]
BDSattva: bets 776
IKE67701: folds 
Uncalled bet (776) returned to BDSattva
BDSattva collected 1551 from pot
*** SUMMARY ***
Total pot 1551 | Rake 0 
Board [9s Kh Ad 3c Qh]
Seat 1: KingMosesTX (big blind) folded on the Turn
Seat 3: Taargeett folded before Flop (didn't bet)
Seat 4: Gilmar735 folded before Flop (didn't bet)
Seat 6: PhxdB420 folded before Flop (didn't bet)
Seat 7: IKE67701 folded on the River
Seat 8: Kishan01 (button) folded before Flop (didn't bet)
Seat 9: BDSattva (small blind) collected (1551)



PokerStars Hand #201497228380: Tournament #2632284264, 17000+3000 Hold'em No Limit - Level VII (100/200) - 2019/06/17 22:10:56 ET
Table '2632284264 3' 9-max Seat #9 is the button
Seat 1: KingMosesTX (2610 in chips) 
Seat 3: Taargeett (3285 in chips) 
Seat 4: Gilmar735 (4631 in chips) 
Seat 6: PhxdB420 (6381 in chips) 
Seat 7: IKE67701 (1482 in chips) 
Seat 8: Kishan01 (2175 in chips) 
Seat 9: BDSattva (4253 in chips) 
KingMosesTX: posts the ante 25
Taargeett: posts the ante 25
Gilmar735: posts the ante 25
PhxdB420: posts the ante 25
IKE67701: posts the ante 25
Kishan01: posts the ante 25
BDSattva: posts the ante 25
KingMosesTX: posts small blind 100
Taargeett: posts big blind 200
*** HOLE CARDS ***
Dealt to Taargeett [8d Qc]
Gilmar735: folds 
PhxdB420: folds 
IKE67701: calls 200
Kishan01: folds 
BDSattva: folds 
KingMosesTX: calls 100
Taargeett: checks 
*** FLOP *** [6h 2d Qs]
KingMosesTX: checks 
Taargeett: bets 400
IKE67701: calls 400
KingMosesTX: folds 
*** TURN *** [6h 2d Qs] [Kh]
Taargeett: checks 
IKE67701: bets 200
Taargeett: raises 400 to 600
IKE67701: calls 400
*** RIVER *** [6h 2d Qs Kh] [7c]
Taargeett: checks 
IKE67701: checks 
*** SHOW DOWN ***
Taargeett: shows [8d Qc] (a pair of Queens)
IKE67701: mucks hand 
Taargeett collected 2775 from pot
*** SUMMARY ***
Total pot 2775 | Rake 0 
Board [6h 2d Qs Kh 7c]
Seat 1: KingMosesTX (small blind) folded on the Flop
Seat 3: Taargeett (big blind) showed [8d Qc] and won (2775) with a pair of Queens
Seat 4: Gilmar735 folded before Flop (didn't bet)
Seat 6: PhxdB420 folded before Flop (didn't bet)
Seat 7: IKE67701 mucked [Ad Th]
Seat 8: Kishan01 folded before Flop (didn't bet)
Seat 9: BDSattva (button) folded before Flop (didn't bet)



PokerStars Hand #201497245832: Tournament #2632284264, 17000+3000 Hold'em No Limit - Level VII (100/200) - 2019/06/17 22:12:07 ET
Table '2632284264 3' 9-max Seat #1 is the button
Seat 1: KingMosesTX (2385 in chips) 
Seat 3: Taargeett (4835 in chips) 
Seat 4: Gilmar735 (4606 in chips) 
Seat 6: PhxdB420 (6356 in chips) 
Seat 7: IKE67701 (257 in chips) 
Seat 8: Kishan01 (2150 in chips) 
Seat 9: BDSattva (4228 in chips) 
KingMosesTX: posts the ante 25
Taargeett: posts the ante 25
Gilmar735: posts the ante 25
PhxdB420: posts the ante 25
IKE67701: posts the ante 25
Kishan01: posts the ante 25
BDSattva: posts the ante 25
Taargeett: posts small blind 100
Gilmar735: posts big blind 200
*** HOLE CARDS ***
Dealt to Taargeett [Ad 8h]
PhxdB420: folds 
IKE67701: folds 
Kishan01: folds 
BDSattva: folds 
KingMosesTX: folds 
Taargeett: raises 200 to 400
Gilmar735: calls 200
*** FLOP *** [9c 3s Qh]
Taargeett: checks 
Gilmar735: checks 
*** TURN *** [9c 3s Qh] [Js]
Taargeett: checks 
Gilmar735: checks 
*** RIVER *** [9c 3s Qh Js] [8d]
Taargeett: bets 975
Gilmar735: folds 
Uncalled bet (975) returned to Taargeett
Taargeett collected 975 from pot
Taargeett: doesn't show hand 
*** SUMMARY ***
Total pot 975 | Rake 0 
Board [9c 3s Qh Js 8d]
Seat 1: KingMosesTX (button) folded before Flop (didn't bet)
Seat 3: Taargeett (small blind) collected (975)
Seat 4: Gilmar735 (big blind) folded on the River
Seat 6: PhxdB420 folded before Flop (didn't bet)
Seat 7: IKE67701 folded before Flop (didn't bet)
Seat 8: Kishan01 folded before Flop (didn't bet)
Seat 9: BDSattva folded before Flop (didn't bet)



PokerStars Hand #201497260278: Tournament #2632284264, 17000+3000 Hold'em No Limit - Level VII (100/200) - 2019/06/17 22:13:05 ET
Table '2632284264 3' 9-max Seat #3 is the button
Seat 1: KingMosesTX (2360 in chips) 
Seat 3: Taargeett (5385 in chips) 
Seat 4: Gilmar735 (4181 in chips) 
Seat 6: PhxdB420 (6331 in chips) 
Seat 7: IKE67701 (232 in chips) 
Seat 8: Kishan01 (2125 in chips) 
Seat 9: BDSattva (4203 in chips) 
KingMosesTX: posts the ante 25
Taargeett: posts the ante 25
Gilmar735: posts the ante 25
PhxdB420: posts the ante 25
IKE67701: posts the ante 25
Kishan01: posts the ante 25
BDSattva: posts the ante 25
Gilmar735: posts small blind 100
PhxdB420: posts big blind 200
*** HOLE CARDS ***
Dealt to Taargeett [Jh 7h]
IKE67701: folds 
Kishan01: folds 
BDSattva: raises 200 to 400
KingMosesTX: folds 
Taargeett: folds 
Gilmar735: folds 
PhxdB420: calls 200
*** FLOP *** [8c 6h 5c]
PhxdB420: checks 
BDSattva: bets 538
PhxdB420: calls 538
*** TURN *** [8c 6h 5c] [Jc]
PhxdB420: checks 
BDSattva: bets 1076
PhxdB420: calls 1076
*** RIVER *** [8c 6h 5c Jc] [7s]
PhxdB420: checks 
BDSattva: checks 
*** SHOW DOWN ***
PhxdB420: shows [Ah 8h] (a pair of Eights)
BDSattva: mucks hand 
PhxdB420 collected 4303 from pot
*** SUMMARY ***
Total pot 4303 | Rake 0 
Board [8c 6h 5c Jc 7s]
Seat 1: KingMosesTX folded before Flop (didn't bet)
Seat 3: Taargeett (button) folded before Flop (didn't bet)
Seat 4: Gilmar735 (small blind) folded before Flop
Seat 6: PhxdB420 (big blind) showed [Ah 8h] and won (4303) with a pair of Eights
Seat 7: IKE67701 folded before Flop (didn't bet)
Seat 8: Kishan01 folded before Flop (didn't bet)
Seat 9: BDSattva mucked [Qd 2d]



PokerStars Hand #201497274151: Tournament #2632284264, 17000+3000 Hold'em No Limit - Level VIII (150/300) - 2019/06/17 22:14:01 ET
Table '2632284264 3' 9-max Seat #4 is the button
Seat 1: KingMosesTX (2335 in chips) 
Seat 3: Taargeett (5360 in chips) 
Seat 4: Gilmar735 (4056 in chips) 
Seat 6: PhxdB420 (8595 in chips) 
Seat 7: IKE67701 (207 in chips) 
Seat 8: Kishan01 (2100 in chips) 
Seat 9: BDSattva (2164 in chips) 
KingMosesTX: posts the ante 25
Taargeett: posts the ante 25
Gilmar735: posts the ante 25
PhxdB420: posts the ante 25
IKE67701: posts the ante 25
Kishan01: posts the ante 25
BDSattva: posts the ante 25
PhxdB420: posts small blind 150
IKE67701: posts big blind 182 and is all-in
*** HOLE CARDS ***
Dealt to Taargeett [7h 9h]
Kishan01: folds 
BDSattva: raises 418 to 600
KingMosesTX: folds 
Taargeett: folds 
Gilmar735: folds 
PhxdB420: folds 
Uncalled bet (418) returned to BDSattva
*** FLOP *** [7d 3c Ad]
*** TURN *** [7d 3c Ad] [Qd]
*** RIVER *** [7d 3c Ad Qd] [6s]
*** SHOW DOWN ***
IKE67701: shows [5d 7s] (a pair of Sevens)
BDSattva: shows [Ah Kh] (a pair of Aces)
BDSattva collected 689 from pot
IKE67701 finished the tournament in 21st place
*** SUMMARY ***
Total pot 689 | Rake 0 
Board [7d 3c Ad Qd 6s]
Seat 1: KingMosesTX folded before Flop (didn't bet)
Seat 3: Taargeett folded before Flop (didn't bet)
Seat 4: Gilmar735 (button) folded before Flop (didn't bet)
Seat 6: PhxdB420 (small blind) folded before Flop
Seat 7: IKE67701 (big blind) showed [5d 7s] and lost with a pair of Sevens
Seat 8: Kishan01 folded before Flop (didn't bet)
Seat 9: BDSattva showed [Ah Kh] and won (689) with a pair of Aces



PokerStars Hand #201497281427: Tournament #2632284264, 17000+3000 Hold'em No Limit - Level VIII (150/300) - 2019/06/17 22:14:31 ET
Table '2632284264 3' 9-max Seat #6 is the button
Seat 1: KingMosesTX (2310 in chips) 
Seat 3: Taargeett (5335 in chips) 
Seat 4: Gilmar735 (4031 in chips) 
Seat 6: PhxdB420 (8420 in chips) 
Seat 8: Kishan01 (2075 in chips) 
Seat 9: BDSattva (2646 in chips) 
KingMosesTX: posts the ante 25
Taargeett: posts the ante 25
Gilmar735: posts the ante 25
PhxdB420: posts the ante 25
Kishan01: posts the ante 25
BDSattva: posts the ante 25
Kishan01: posts small blind 150
BDSattva: posts big blind 300
*** HOLE CARDS ***
Dealt to Taargeett [5d Jd]
KingMosesTX: folds 
Taargeett: folds 
Gilmar735: folds 
PhxdB420: folds 
Kishan01: raises 300 to 600
BDSattva: calls 300
*** FLOP *** [8s 9s Td]
Kishan01: bets 1450 and is all-in
BDSattva: folds 
Uncalled bet (1450) returned to Kishan01
Kishan01 collected 1350 from pot
Kishan01: doesn't show hand 
*** SUMMARY ***
Total pot 1350 | Rake 0 
Board [8s 9s Td]
Seat 1: KingMosesTX folded before Flop (didn't bet)
Seat 3: Taargeett folded before Flop (didn't bet)
Seat 4: Gilmar735 folded before Flop (didn't bet)
Seat 6: PhxdB420 (button) folded before Flop (didn't bet)
Seat 8: Kishan01 (small blind) collected (1350)
Seat 9: BDSattva (big blind) folded on the Flop



PokerStars Hand #201497290241: Tournament #2632284264, 17000+3000 Hold'em No Limit - Level VIII (150/300) - 2019/06/17 22:15:07 ET
Table '2632284264 3' 9-max Seat #8 is the button
Seat 1: KingMosesTX (2285 in chips) 
Seat 3: Taargeett (5310 in chips) 
Seat 4: Gilmar735 (4006 in chips) 
Seat 6: PhxdB420 (8395 in chips) 
Seat 8: Kishan01 (2800 in chips) 
Seat 9: BDSattva (2021 in chips) 
KingMosesTX: posts the ante 25
Taargeett: posts the ante 25
Gilmar735: posts the ante 25
PhxdB420: posts the ante 25
Kishan01: posts the ante 25
BDSattva: posts the ante 25
BDSattva: posts small blind 150
KingMosesTX: posts big blind 300
*** HOLE CARDS ***
Dealt to Taargeett [5h 7h]
Taargeett has timed out
Taargeett: folds 
Gilmar735: calls 300
PhxdB420: folds 
Kishan01: folds 
BDSattva: calls 150
KingMosesTX: checks 
*** FLOP *** [Ts Jd 7d]
BDSattva: bets 1696 and is all-in
KingMosesTX: folds 
Gilmar735: calls 1696
*** TURN *** [Ts Jd 7d] [3h]
*** RIVER *** [Ts Jd 7d 3h] [6d]
*** SHOW DOWN ***
BDSattva: shows [5c Tc] (a pair of Tens)
Gilmar735: shows [Kh Js] (a pair of Jacks)
Gilmar735 collected 4442 from pot
BDSattva finished the tournament in 19th place
*** SUMMARY ***
Total pot 4442 | Rake 0 
Board [Ts Jd 7d 3h 6d]
Seat 1: KingMosesTX (big blind) folded on the Flop
Seat 3: Taargeett folded before Flop (didn't bet)
Seat 4: Gilmar735 showed [Kh Js] and won (4442) with a pair of Jacks
Seat 6: PhxdB420 folded before Flop (didn't bet)
Seat 8: Kishan01 (button) folded before Flop (didn't bet)
Seat 9: BDSattva (small blind) showed [5c Tc] and lost with a pair of Tens



PokerStars Hand #201497321151: Tournament #2632284264, 17000+3000 Hold'em No Limit - Level VIII (150/300) - 2019/06/17 22:17:11 ET
Table '2632284264 4' 9-max Seat #3 is the button
Seat 1: drawten (445 in chips) 
Seat 2: Taargeett (5285 in chips) 
Seat 3: concorddeadi (5990 in chips) 
Seat 5: A8tung (7510 in chips) 
Seat 6: PhxdB420 (8345 in chips) 
Seat 8: crazygal777 (5445 in chips) 
Seat 9: Gerrysemi (8260 in chips) 
drawten: posts the ante 25
Taargeett: posts the ante 25
concorddeadi: posts the ante 25
A8tung: posts the ante 25
PhxdB420: posts the ante 25
crazygal777: posts the ante 25
Gerrysemi: posts the ante 25
A8tung: posts small blind 150
PhxdB420: posts big blind 300
*** HOLE CARDS ***
Dealt to Taargeett [8s 7h]
crazygal777: folds 
Gerrysemi: folds 
drawten: calls 300
Taargeett: folds 
concorddeadi: calls 300
A8tung: raises 7185 to 7485 and is all-in
PhxdB420: folds 
drawten: calls 120 and is all-in
concorddeadi: folds 
Uncalled bet (7065) returned to A8tung
*** FLOP *** [2c 4d Kh]
*** TURN *** [2c 4d Kh] [Kc]
*** RIVER *** [2c 4d Kh Kc] [Td]
*** SHOW DOWN ***
A8tung: shows [As Jc] (a pair of Kings)
drawten: shows [6d 6h] (two pair, Kings and Sixes)
drawten collected 1615 from pot
*** SUMMARY ***
Total pot 1615 | Rake 0 
Board [2c 4d Kh Kc Td]
Seat 1: drawten showed [6d 6h] and won (1615) with two pair, Kings and Sixes
Seat 2: Taargeett folded before Flop (didn't bet)
Seat 3: concorddeadi (button) folded before Flop
Seat 5: A8tung (small blind) showed [As Jc] and lost with a pair of Kings
Seat 6: PhxdB420 (big blind) folded before Flop
Seat 8: crazygal777 folded before Flop (didn't bet)
Seat 9: Gerrysemi folded before Flop (didn't bet)



PokerStars Hand #201497331685: Tournament #2632284264, 17000+3000 Hold'em No Limit - Level VIII (150/300) - 2019/06/17 22:17:54 ET
Table '2632284264 4' 9-max Seat #5 is the button
Seat 1: drawten (1615 in chips) 
Seat 2: Taargeett (5260 in chips) 
Seat 3: concorddeadi (5665 in chips) 
Seat 5: A8tung (7065 in chips) 
Seat 6: PhxdB420 (8020 in chips) 
Seat 8: crazygal777 (5420 in chips) 
Seat 9: Gerrysemi (8235 in chips) 
drawten: posts the ante 25
Taargeett: posts the ante 25
concorddeadi: posts the ante 25
A8tung: posts the ante 25
PhxdB420: posts the ante 25
crazygal777: posts the ante 25
Gerrysemi: posts the ante 25
PhxdB420: posts small blind 150
crazygal777: posts big blind 300
*** HOLE CARDS ***
Dealt to Taargeett [2h Kd]
Gerrysemi: folds 
drawten: folds 
Taargeett: folds 
concorddeadi: folds 
A8tung: folds 
PhxdB420: raises 600 to 900
crazygal777: folds 
Uncalled bet (600) returned to PhxdB420
PhxdB420 collected 775 from pot
PhxdB420: doesn't show hand 
*** SUMMARY ***
Total pot 775 | Rake 0 
Seat 1: drawten folded before Flop (didn't bet)
Seat 2: Taargeett folded before Flop (didn't bet)
Seat 3: concorddeadi folded before Flop (didn't bet)
Seat 5: A8tung (button) folded before Flop (didn't bet)
Seat 6: PhxdB420 (small blind) collected (775)
Seat 8: crazygal777 (big blind) folded before Flop
Seat 9: Gerrysemi folded before Flop (didn't bet)



PokerStars Hand #201497350612: Tournament #2632284264, 17000+3000 Hold'em No Limit - Level IX (200/400) - 2019/06/17 22:19:11 ET
Table '2632284264 4' 9-max Seat #6 is the button
Seat 1: drawten (1590 in chips) 
Seat 2: Taargeett (5235 in chips) 
Seat 3: concorddeadi (5640 in chips) 
Seat 5: A8tung (7040 in chips) 
Seat 6: PhxdB420 (8470 in chips) 
Seat 8: crazygal777 (5095 in chips) 
Seat 9: Gerrysemi (8210 in chips) 
drawten: posts the ante 25
Taargeett: posts the ante 25
concorddeadi: posts the ante 25
A8tung: posts the ante 25
PhxdB420: posts the ante 25
crazygal777: posts the ante 25
Gerrysemi: posts the ante 25
crazygal777: posts small blind 200
Gerrysemi: posts big blind 400
*** HOLE CARDS ***
Dealt to Taargeett [8h Td]
drawten: folds 
Taargeett: folds 
concorddeadi: folds 
A8tung: raises 800 to 1200
PhxdB420 has timed out
PhxdB420: folds 
crazygal777: folds 
Gerrysemi: calls 800
*** FLOP *** [Kd Ks 9d]
Gerrysemi: checks 
A8tung: bets 1388
Gerrysemi: folds 
Uncalled bet (1388) returned to A8tung
A8tung collected 2775 from pot
*** SUMMARY ***
Total pot 2775 | Rake 0 
Board [Kd Ks 9d]
Seat 1: drawten folded before Flop (didn't bet)
Seat 2: Taargeett folded before Flop (didn't bet)
Seat 3: concorddeadi folded before Flop (didn't bet)
Seat 5: A8tung collected (2775)
Seat 6: PhxdB420 (button) folded before Flop (didn't bet)
Seat 8: crazygal777 (small blind) folded before Flop
Seat 9: Gerrysemi (big blind) folded on the Flop



PokerStars Hand #201497368686: Tournament #2632284264, 17000+3000 Hold'em No Limit - Level IX (200/400) - 2019/06/17 22:20:25 ET
Table '2632284264 4' 9-max Seat #8 is the button
Seat 1: drawten (1565 in chips) 
Seat 2: Taargeett (5210 in chips) 
Seat 3: concorddeadi (5615 in chips) 
Seat 5: A8tung (8590 in chips) 
Seat 6: PhxdB420 (8445 in chips) 
Seat 8: crazygal777 (4870 in chips) 
Seat 9: Gerrysemi (6985 in chips) 
drawten: posts the ante 25
Taargeett: posts the ante 25
concorddeadi: posts the ante 25
A8tung: posts the ante 25
PhxdB420: posts the ante 25
crazygal777: posts the ante 25
Gerrysemi: posts the ante 25
Gerrysemi: posts small blind 200
drawten: posts big blind 400
*** HOLE CARDS ***
Dealt to Taargeett [5s 9d]
Taargeett: folds 
concorddeadi: calls 400
A8tung: folds 
PhxdB420: calls 400
crazygal777: folds 
Gerrysemi: calls 200
drawten: checks 
*** FLOP *** [Qd 2d 2h]
Gerrysemi: checks 
drawten: checks 
concorddeadi: checks 
PhxdB420: checks 
*** TURN *** [Qd 2d 2h] [7c]
Gerrysemi: checks 
drawten: checks 
concorddeadi: checks 
PhxdB420: checks 
*** RIVER *** [Qd 2d 2h 7c] [As]
Gerrysemi: checks 
drawten: bets 400
concorddeadi: folds 
PhxdB420: calls 400
Gerrysemi: folds 
*** SHOW DOWN ***
drawten: shows [Ts Ah] (two pair, Aces and Deuces)
PhxdB420: mucks hand 
drawten collected 2575 from pot
*** SUMMARY ***
Total pot 2575 | Rake 0 
Board [Qd 2d 2h 7c As]
Seat 1: drawten (big blind) showed [Ts Ah] and won (2575) with two pair, Aces and Deuces
Seat 2: Taargeett folded before Flop (didn't bet)
Seat 3: concorddeadi folded on the River
Seat 5: A8tung folded before Flop (didn't bet)
Seat 6: PhxdB420 mucked [7h 8h]
Seat 8: crazygal777 (button) folded before Flop (didn't bet)
Seat 9: Gerrysemi (small blind) folded on the River



PokerStars Hand #201497396130: Tournament #2632284264, 17000+3000 Hold'em No Limit - Level IX (200/400) - 2019/06/17 22:22:18 ET
Table '2632284264 4' 9-max Seat #9 is the button
Seat 1: drawten (3315 in chips) 
Seat 2: Taargeett (5185 in chips) 
Seat 3: concorddeadi (5190 in chips) 
Seat 5: A8tung (8565 in chips) 
Seat 6: PhxdB420 (7620 in chips) 
Seat 8: crazygal777 (4845 in chips) 
Seat 9: Gerrysemi (6560 in chips) 
drawten: posts the ante 25
Taargeett: posts the ante 25
concorddeadi: posts the ante 25
A8tung: posts the ante 25
PhxdB420: posts the ante 25
crazygal777: posts the ante 25
Gerrysemi: posts the ante 25
drawten: posts small blind 200
Taargeett: posts big blind 400
*** HOLE CARDS ***
Dealt to Taargeett [4d Js]
concorddeadi: folds 
A8tung: folds 
PhxdB420: folds 
crazygal777: folds 
Gerrysemi: calls 400
drawten: calls 200
Taargeett: checks 
*** FLOP *** [2d 5h Qh]
drawten: checks 
Taargeett: checks 
Gerrysemi: checks 
*** TURN *** [2d 5h Qh] [Th]
drawten: checks 
Taargeett: checks 
Gerrysemi: checks 
*** RIVER *** [2d 5h Qh Th] [As]
drawten: checks 
Taargeett: checks 
Gerrysemi: checks 
*** SHOW DOWN ***
drawten: shows [Ac 8s] (a pair of Aces)
Taargeett: mucks hand 
Gerrysemi: mucks hand 
drawten collected 1375 from pot
*** SUMMARY ***
Total pot 1375 | Rake 0 
Board [2d 5h Qh Th As]
Seat 1: drawten (small blind) showed [Ac 8s] and won (1375) with a pair of Aces
Seat 2: Taargeett (big blind) mucked [4d Js]
Seat 3: concorddeadi folded before Flop (didn't bet)
Seat 5: A8tung folded before Flop (didn't bet)
Seat 6: PhxdB420 folded before Flop (didn't bet)
Seat 8: crazygal777 folded before Flop (didn't bet)
Seat 9: Gerrysemi (button) mucked [9s 8h]



PokerStars Hand #201497410160: Tournament #2632284264, 17000+3000 Hold'em No Limit - Level IX (200/400) - 2019/06/17 22:23:16 ET
Table '2632284264 4' 9-max Seat #1 is the button
Seat 1: drawten (4265 in chips) 
Seat 2: Taargeett (4760 in chips) 
Seat 3: concorddeadi (5165 in chips) 
Seat 5: A8tung (8540 in chips) 
Seat 6: PhxdB420 (7595 in chips) 
Seat 8: crazygal777 (4820 in chips) 
Seat 9: Gerrysemi (6135 in chips) 
drawten: posts the ante 25
Taargeett: posts the ante 25
concorddeadi: posts the ante 25
A8tung: posts the ante 25
PhxdB420: posts the ante 25
crazygal777: posts the ante 25
Gerrysemi: posts the ante 25
Taargeett: posts small blind 200
concorddeadi: posts big blind 400
*** HOLE CARDS ***
Dealt to Taargeett [2d 9h]
A8tung: folds 
PhxdB420: raises 800 to 1200
crazygal777: folds 
Gerrysemi: folds 
drawten: raises 800 to 2000
Taargeett: folds 
concorddeadi: folds 
PhxdB420: calls 800
*** FLOP *** [7c 9c 4c]
PhxdB420: checks 
drawten: bets 2240 and is all-in
PhxdB420: calls 2240
*** TURN *** [7c 9c 4c] [6h]
*** RIVER *** [7c 9c 4c 6h] [Qs]
*** SHOW DOWN ***
PhxdB420: shows [Qc Kh] (a pair of Queens)
drawten: shows [Ks 4s] (a pair of Fours)
PhxdB420 collected 9255 from pot
drawten finished the tournament in 15th place
*** SUMMARY ***
Total pot 9255 | Rake 0 
Board [7c 9c 4c 6h Qs]
Seat 1: drawten (button) showed [Ks 4s] and lost with a pair of Fours
Seat 2: Taargeett (small blind) folded before Flop
Seat 3: concorddeadi (big blind) folded before Flop
Seat 5: A8tung folded before Flop (didn't bet)
Seat 6: PhxdB420 showed [Qc Kh] and won (9255) with a pair of Queens
Seat 8: crazygal777 folded before Flop (didn't bet)
Seat 9: Gerrysemi folded before Flop (didn't bet)



PokerStars Hand #201497423232: Tournament #2632284264, 17000+3000 Hold'em No Limit - Level X (300/600) - 2019/06/17 22:24:10 ET
Table '2632284264 4' 9-max Seat #2 is the button
Seat 2: Taargeett (4535 in chips) 
Seat 3: concorddeadi (4740 in chips) 
Seat 5: A8tung (8515 in chips) 
Seat 6: PhxdB420 (12585 in chips) 
Seat 8: crazygal777 (4795 in chips) 
Seat 9: Gerrysemi (6110 in chips) 
Taargeett: posts the ante 50
concorddeadi: posts the ante 50
A8tung: posts the ante 50
PhxdB420: posts the ante 50
crazygal777: posts the ante 50
Gerrysemi: posts the ante 50
concorddeadi: posts small blind 300
A8tung: posts big blind 600
*** HOLE CARDS ***
Dealt to Taargeett [Jd 6h]
PhxdB420: raises 1200 to 1800
crazygal777: folds 
Gerrysemi: folds 
Taargeett: folds 
concorddeadi: calls 1500
A8tung: folds 
*** FLOP *** [9c Qd Js]
concorddeadi: bets 2890 and is all-in
PhxdB420: folds 
Uncalled bet (2890) returned to concorddeadi
concorddeadi collected 4500 from pot
concorddeadi: doesn't show hand 
*** SUMMARY ***
Total pot 4500 | Rake 0 
Board [9c Qd Js]
Seat 2: Taargeett (button) folded before Flop (didn't bet)
Seat 3: concorddeadi (small blind) collected (4500)
Seat 5: A8tung (big blind) folded before Flop
Seat 6: PhxdB420 folded on the Flop
Seat 8: crazygal777 folded before Flop (didn't bet)
Seat 9: Gerrysemi folded before Flop (didn't bet)



PokerStars Hand #201497433784: Tournament #2632284264, 17000+3000 Hold'em No Limit - Level X (300/600) - 2019/06/17 22:24:53 ET
Table '2632284264 4' 9-max Seat #3 is the button
Seat 2: Taargeett (4485 in chips) 
Seat 3: concorddeadi (7390 in chips) 
Seat 5: A8tung (7865 in chips) 
Seat 6: PhxdB420 (10735 in chips) 
Seat 7: mpduke (2480 in chips) 
Seat 8: crazygal777 (4745 in chips) 
Seat 9: Gerrysemi (6060 in chips) 
Taargeett: posts the ante 50
concorddeadi: posts the ante 50
A8tung: posts the ante 50
PhxdB420: posts the ante 50
mpduke: posts the ante 50
crazygal777: posts the ante 50
Gerrysemi: posts the ante 50
A8tung: posts small blind 300
PhxdB420: posts big blind 600
*** HOLE CARDS ***
Dealt to Taargeett [8h 2c]
mpduke: folds 
crazygal777: folds 
Gerrysemi: folds 
Taargeett: folds 
concorddeadi: calls 600
A8tung: folds 
PhxdB420: raises 1200 to 1800
concorddeadi: calls 1200
*** FLOP *** [2h 8c Jd]
PhxdB420: bets 2000
concorddeadi: raises 3540 to 5540 and is all-in
PhxdB420: calls 3540
*** TURN *** [2h 8c Jd] [5s]
*** RIVER *** [2h 8c Jd 5s] [9d]
*** SHOW DOWN ***
PhxdB420: shows [7c 7h] (a pair of Sevens)
concorddeadi: shows [As Jh] (a pair of Jacks)
concorddeadi collected 15330 from pot
*** SUMMARY ***
Total pot 15330 | Rake 0 
Board [2h 8c Jd 5s 9d]
Seat 2: Taargeett folded before Flop (didn't bet)
Seat 3: concorddeadi (button) showed [As Jh] and won (15330) with a pair of Jacks
Seat 5: A8tung (small blind) folded before Flop
Seat 6: PhxdB420 (big blind) showed [7c 7h] and lost with a pair of Sevens
Seat 7: mpduke folded before Flop (didn't bet)
Seat 8: crazygal777 folded before Flop (didn't bet)
Seat 9: Gerrysemi folded before Flop (didn't bet)



PokerStars Hand #201497447744: Tournament #2632284264, 17000+3000 Hold'em No Limit - Level X (300/600) - 2019/06/17 22:25:52 ET
Table '2632284264 4' 9-max Seat #5 is the button
Seat 2: Taargeett (4435 in chips) 
Seat 3: concorddeadi (15330 in chips) 
Seat 5: A8tung (7515 in chips) 
Seat 6: PhxdB420 (3345 in chips) 
Seat 7: mpduke (2430 in chips) 
Seat 8: crazygal777 (4695 in chips) 
Seat 9: Gerrysemi (6010 in chips) 
Taargeett: posts the ante 50
concorddeadi: posts the ante 50
A8tung: posts the ante 50
PhxdB420: posts the ante 50
mpduke: posts the ante 50
crazygal777: posts the ante 50
Gerrysemi: posts the ante 50
PhxdB420: posts small blind 300
mpduke: posts big blind 600
*** HOLE CARDS ***
Dealt to Taargeett [5d 9c]
crazygal777: folds 
Gerrysemi: folds 
Taargeett: folds 
concorddeadi: folds 
A8tung: folds 
PhxdB420: raises 1200 to 1800
mpduke: calls 1200
*** FLOP *** [Js 2c 8c]
PhxdB420: checks 
mpduke: bets 580 and is all-in
PhxdB420: calls 580
*** TURN *** [Js 2c 8c] [8d]
*** RIVER *** [Js 2c 8c 8d] [Jc]
*** SHOW DOWN ***
PhxdB420: shows [2s 9d] (two pair, Jacks and Eights)
mpduke: shows [3s 5s] (two pair, Jacks and Eights - lower kicker)
PhxdB420 collected 5110 from pot
mpduke finished the tournament in 13th place
*** SUMMARY ***
Total pot 5110 | Rake 0 
Board [Js 2c 8c 8d Jc]
Seat 2: Taargeett folded before Flop (didn't bet)
Seat 3: concorddeadi folded before Flop (didn't bet)
Seat 5: A8tung (button) folded before Flop (didn't bet)
Seat 6: PhxdB420 (small blind) showed [2s 9d] and won (5110) with two pair, Jacks and Eights
Seat 7: mpduke (big blind) showed [3s 5s] and lost with two pair, Jacks and Eights
Seat 8: crazygal777 folded before Flop (didn't bet)
Seat 9: Gerrysemi folded before Flop (didn't bet)



PokerStars Hand #201497455702: Tournament #2632284264, 17000+3000 Hold'em No Limit - Level X (300/600) - 2019/06/17 22:26:25 ET
Table '2632284264 4' 9-max Seat #6 is the button
Seat 2: Taargeett (4385 in chips) 
Seat 3: concorddeadi (15280 in chips) 
Seat 5: A8tung (7465 in chips) 
Seat 6: PhxdB420 (6025 in chips) 
Seat 8: crazygal777 (4645 in chips) 
Seat 9: Gerrysemi (5960 in chips) 
Taargeett: posts the ante 50
concorddeadi: posts the ante 50
A8tung: posts the ante 50
PhxdB420: posts the ante 50
crazygal777: posts the ante 50
Gerrysemi: posts the ante 50
crazygal777: posts small blind 300
Gerrysemi: posts big blind 600
*** HOLE CARDS ***
Dealt to Taargeett [Ts Kc]
Taargeett: folds 
concorddeadi: folds 
A8tung: folds 
PhxdB420: folds 
crazygal777: calls 300
Gerrysemi: checks 
*** FLOP *** [3s 7c 8d]
crazygal777: bets 600
Gerrysemi: calls 600
*** TURN *** [3s 7c 8d] [Tc]
crazygal777: bets 600
Gerrysemi: calls 600
*** RIVER *** [3s 7c 8d Tc] [2s]
crazygal777: bets 600
Gerrysemi: calls 600
*** SHOW DOWN ***
crazygal777: shows [3h As] (a pair of Threes)
Gerrysemi: mucks hand 
crazygal777 collected 5100 from pot
*** SUMMARY ***
Total pot 5100 | Rake 0 
Board [3s 7c 8d Tc 2s]
Seat 2: Taargeett folded before Flop (didn't bet)
Seat 3: concorddeadi folded before Flop (didn't bet)
Seat 5: A8tung folded before Flop (didn't bet)
Seat 6: PhxdB420 (button) folded before Flop (didn't bet)
Seat 8: crazygal777 (small blind) showed [3h As] and won (5100) with a pair of Threes
Seat 9: Gerrysemi (big blind) mucked [9s 4h]



PokerStars Hand #201497470376: Tournament #2632284264, 17000+3000 Hold'em No Limit - Level X (300/600) - 2019/06/17 22:27:13 ET
Table '2632284264 4' 9-max Seat #8 is the button
Seat 2: Taargeett (4335 in chips) 
Seat 3: concorddeadi (15230 in chips) 
Seat 5: A8tung (7415 in chips) 
Seat 6: PhxdB420 (5975 in chips) 
Seat 8: crazygal777 (7295 in chips) 
Seat 9: Gerrysemi (3510 in chips) 
Taargeett: posts the ante 50
concorddeadi: posts the ante 50
A8tung: posts the ante 50
PhxdB420: posts the ante 50
crazygal777: posts the ante 50
Gerrysemi: posts the ante 50
Gerrysemi: posts small blind 300
Taargeett: posts big blind 600
*** HOLE CARDS ***
Dealt to Taargeett [6d 9h]
concorddeadi: folds 
A8tung: folds 
PhxdB420: folds 
crazygal777: folds 
Gerrysemi: raises 2860 to 3460 and is all-in
Taargeett: folds 
Uncalled bet (2860) returned to Gerrysemi
Gerrysemi collected 1500 from pot
Gerrysemi: doesn't show hand 
*** SUMMARY ***
Total pot 1500 | Rake 0 
Seat 2: Taargeett (big blind) folded before Flop
Seat 3: concorddeadi folded before Flop (didn't bet)
Seat 5: A8tung folded before Flop (didn't bet)
Seat 6: PhxdB420 folded before Flop (didn't bet)
Seat 8: crazygal777 (button) folded before Flop (didn't bet)
Seat 9: Gerrysemi (small blind) collected (1500)



PokerStars Hand #201497475772: Tournament #2632284264, 17000+3000 Hold'em No Limit - Level X (300/600) - 2019/06/17 22:27:36 ET
Table '2632284264 4' 9-max Seat #9 is the button
Seat 2: Taargeett (3685 in chips) 
Seat 3: concorddeadi (15180 in chips) 
Seat 5: A8tung (7365 in chips) 
Seat 6: PhxdB420 (5925 in chips) 
Seat 8: crazygal777 (7245 in chips) 
Seat 9: Gerrysemi (4360 in chips) 
Taargeett: posts the ante 50
concorddeadi: posts the ante 50
A8tung: posts the ante 50
PhxdB420: posts the ante 50
crazygal777: posts the ante 50
Gerrysemi: posts the ante 50
Taargeett: posts small blind 300
concorddeadi: posts big blind 600
*** HOLE CARDS ***
Dealt to Taargeett [7h 8h]
A8tung: folds 
PhxdB420: raises 1200 to 1800
crazygal777: folds 
Gerrysemi: folds 
Taargeett: folds 
concorddeadi: calls 1200
*** FLOP *** [Jh 8d 2c]
concorddeadi: checks 
PhxdB420: bets 2100
concorddeadi: folds 
Uncalled bet (2100) returned to PhxdB420
PhxdB420 collected 4200 from pot
PhxdB420: doesn't show hand 
*** SUMMARY ***
Total pot 4200 | Rake 0 
Board [Jh 8d 2c]
Seat 2: Taargeett (small blind) folded before Flop
Seat 3: concorddeadi (big blind) folded on the Flop
Seat 5: A8tung folded before Flop (didn't bet)
Seat 6: PhxdB420 collected (4200)
Seat 8: crazygal777 folded before Flop (didn't bet)
Seat 9: Gerrysemi (button) folded before Flop (didn't bet)



PokerStars Hand #201497485588: Tournament #2632284264, 17000+3000 Hold'em No Limit - Level X (300/600) - 2019/06/17 22:28:17 ET
Table '2632284264 4' 9-max Seat #2 is the button
Seat 2: Taargeett (3335 in chips) 
Seat 3: concorddeadi (13330 in chips) 
Seat 5: A8tung (7315 in chips) 
Seat 6: PhxdB420 (8275 in chips) 
Seat 8: crazygal777 (7195 in chips) 
Seat 9: Gerrysemi (4310 in chips) 
Taargeett: posts the ante 50
concorddeadi: posts the ante 50
A8tung: posts the ante 50
PhxdB420: posts the ante 50
crazygal777: posts the ante 50
Gerrysemi: posts the ante 50
concorddeadi: posts small blind 300
A8tung: posts big blind 600
*** HOLE CARDS ***
Dealt to Taargeett [6d As]
PhxdB420: folds 
crazygal777: folds 
Gerrysemi: folds 
Taargeett: raises 2685 to 3285 and is all-in
concorddeadi: folds 
A8tung: folds 
Uncalled bet (2685) returned to Taargeett
Taargeett collected 1800 from pot
Taargeett: doesn't show hand 
*** SUMMARY ***
Total pot 1800 | Rake 0 
Seat 2: Taargeett (button) collected (1800)
Seat 3: concorddeadi (small blind) folded before Flop
Seat 5: A8tung (big blind) folded before Flop
Seat 6: PhxdB420 folded before Flop (didn't bet)
Seat 8: crazygal777 folded before Flop (didn't bet)
Seat 9: Gerrysemi folded before Flop (didn't bet)



PokerStars Hand #201497491213: Tournament #2632284264, 17000+3000 Hold'em No Limit - Level X (300/600) - 2019/06/17 22:28:41 ET
Table '2632284264 4' 9-max Seat #3 is the button
Seat 2: Taargeett (4485 in chips) 
Seat 3: concorddeadi (12980 in chips) 
Seat 5: A8tung (6665 in chips) 
Seat 6: PhxdB420 (8225 in chips) 
Seat 8: crazygal777 (7145 in chips) 
Seat 9: Gerrysemi (4260 in chips) 
Taargeett: posts the ante 50
concorddeadi: posts the ante 50
A8tung: posts the ante 50
PhxdB420: posts the ante 50
crazygal777: posts the ante 50
Gerrysemi: posts the ante 50
A8tung: posts small blind 300
PhxdB420: posts big blind 600
*** HOLE CARDS ***
Dealt to Taargeett [3d 4s]
crazygal777: calls 600
Gerrysemi: calls 600
Taargeett: folds 
concorddeadi: calls 600
A8tung: raises 6015 to 6615 and is all-in
PhxdB420: folds 
crazygal777: folds 
Gerrysemi: calls 3610 and is all-in
concorddeadi: folds 
Uncalled bet (2405) returned to A8tung
*** FLOP *** [5d Qh 6d]
*** TURN *** [5d Qh 6d] [5s]
*** RIVER *** [5d Qh 6d 5s] [3s]
*** SHOW DOWN ***
A8tung: shows [4h Ac] (a pair of Fives)
Gerrysemi: shows [Js Ah] (a pair of Fives - Ace+Queen+Jack kicker)
Gerrysemi collected 10520 from pot
*** SUMMARY ***
Total pot 10520 | Rake 0 
Board [5d Qh 6d 5s 3s]
Seat 2: Taargeett folded before Flop (didn't bet)
Seat 3: concorddeadi (button) folded before Flop
Seat 5: A8tung (small blind) showed [4h Ac] and lost with a pair of Fives
Seat 6: PhxdB420 (big blind) folded before Flop
Seat 8: crazygal777 folded before Flop
Seat 9: Gerrysemi showed [Js Ah] and won (10520) with a pair of Fives



PokerStars Hand #201497501027: Tournament #2632284264, 17000+3000 Hold'em No Limit - Level XI (400/800) - 2019/06/17 22:29:23 ET
Table '2632284264 4' 9-max Seat #5 is the button
Seat 2: Taargeett (4435 in chips) 
Seat 3: concorddeadi (12330 in chips) 
Seat 5: A8tung (2405 in chips) 
Seat 6: PhxdB420 (7575 in chips) 
Seat 8: crazygal777 (6495 in chips) 
Seat 9: Gerrysemi (10520 in chips) 
Taargeett: posts the ante 50
concorddeadi: posts the ante 50
A8tung: posts the ante 50
PhxdB420: posts the ante 50
crazygal777: posts the ante 50
Gerrysemi: posts the ante 50
PhxdB420: posts small blind 400
crazygal777: posts big blind 800
*** HOLE CARDS ***
Dealt to Taargeett [5d 3d]
Gerrysemi: calls 800
Taargeett: folds 
concorddeadi: folds 
A8tung: folds 
PhxdB420: folds 
crazygal777: checks 
*** FLOP *** [7c 3h 2h]
crazygal777: checks 
Gerrysemi: checks 
*** TURN *** [7c 3h 2h] [5h]
crazygal777: bets 800
Gerrysemi: calls 800
*** RIVER *** [7c 3h 2h 5h] [As]
crazygal777: bets 800
Gerrysemi: raises 2400 to 3200
crazygal777: raises 1645 to 4845 and is all-in
Gerrysemi: calls 1645
*** SHOW DOWN ***
crazygal777: shows [5s 5c] (three of a kind, Fives)
Gerrysemi: shows [Ac Kh] (a pair of Aces)
crazygal777 collected 13590 from pot
*** SUMMARY ***
Total pot 13590 | Rake 0 
Board [7c 3h 2h 5h As]
Seat 2: Taargeett folded before Flop (didn't bet)
Seat 3: concorddeadi folded before Flop (didn't bet)
Seat 5: A8tung (button) folded before Flop (didn't bet)
Seat 6: PhxdB420 (small blind) folded before Flop
Seat 8: crazygal777 (big blind) showed [5s 5c] and won (13590) with three of a kind, Fives
Seat 9: Gerrysemi showed [Ac Kh] and lost with a pair of Aces



PokerStars Hand #201497515113: Tournament #2632284264, 17000+3000 Hold'em No Limit - Level XI (400/800) - 2019/06/17 22:30:22 ET
Table '2632284264 4' 9-max Seat #6 is the button
Seat 1: Kopplin1 (2000 in chips) 
Seat 2: Taargeett (4385 in chips) 
Seat 3: concorddeadi (12280 in chips) 
Seat 4: Gilmar735 (8227 in chips) 
Seat 5: A8tung (2355 in chips) 
Seat 6: PhxdB420 (7125 in chips) 
Seat 7: buck17202394 (13513 in chips) out of hand (moved from another table into small blind)
Seat 8: crazygal777 (13590 in chips) 
Seat 9: Gerrysemi (4025 in chips) 
buck17202394 will be allowed to play after the button
Kopplin1: posts the ante 50
Taargeett: posts the ante 50
concorddeadi: posts the ante 50
Gilmar735: posts the ante 50
A8tung: posts the ante 50
PhxdB420: posts the ante 50
crazygal777: posts the ante 50
Gerrysemi: posts the ante 50
crazygal777: posts small blind 400
Gerrysemi: posts big blind 800
*** HOLE CARDS ***
Dealt to Taargeett [Jh 6c]
Kopplin1: folds 
Taargeett: folds 
concorddeadi: folds 
Gilmar735: folds 
A8tung: folds 
PhxdB420: raises 1600 to 2400
crazygal777: folds 
Gerrysemi: raises 1575 to 3975 and is all-in
PhxdB420: calls 1575
*** FLOP *** [2s Td 9h]
*** TURN *** [2s Td 9h] [8d]
*** RIVER *** [2s Td 9h 8d] [2c]
*** SHOW DOWN ***
Gerrysemi: shows [Ac 3c] (a pair of Deuces)
PhxdB420: shows [Jd 9d] (two pair, Nines and Deuces)
PhxdB420 collected 8750 from pot
Gerrysemi finished the tournament in 9th place
*** SUMMARY ***
Total pot 8750 | Rake 0 
Board [2s Td 9h 8d 2c]
Seat 1: Kopplin1 folded before Flop (didn't bet)
Seat 2: Taargeett folded before Flop (didn't bet)
Seat 3: concorddeadi folded before Flop (didn't bet)
Seat 4: Gilmar735 folded before Flop (didn't bet)
Seat 5: A8tung folded before Flop (didn't bet)
Seat 6: PhxdB420 (button) showed [Jd 9d] and won (8750) with two pair, Nines and Deuces
Seat 8: crazygal777 (small blind) folded before Flop
Seat 9: Gerrysemi (big blind) showed [Ac 3c] and lost with a pair of Deuces



PokerStars Hand #201497524019: Tournament #2632284264, 17000+3000 Hold'em No Limit - Level XI (400/800) - 2019/06/17 22:31:00 ET
Table '2632284264 4' 9-max Seat #8 is the button
Seat 1: Kopplin1 (1950 in chips) 
Seat 2: Taargeett (4335 in chips) 
Seat 3: concorddeadi (12230 in chips) 
Seat 4: Gilmar735 (8177 in chips) 
Seat 5: A8tung (2305 in chips) 
Seat 6: PhxdB420 (11850 in chips) 
Seat 7: buck17202394 (13513 in chips) 
Seat 8: crazygal777 (13140 in chips) 
Kopplin1: posts the ante 50
Taargeett: posts the ante 50
concorddeadi: posts the ante 50
Gilmar735: posts the ante 50
A8tung: posts the ante 50
PhxdB420: posts the ante 50
buck17202394: posts the ante 50
crazygal777: posts the ante 50
Kopplin1: posts small blind 400
Taargeett: posts big blind 800
*** HOLE CARDS ***
Dealt to Taargeett [5s Jd]
concorddeadi: folds 
Gilmar735: folds 
A8tung: folds 
PhxdB420: folds 
buck17202394: calls 800
crazygal777: calls 800
Kopplin1: folds 
Taargeett: checks 
*** FLOP *** [Th 3c 7c]
Taargeett: checks 
buck17202394: checks 
crazygal777: bets 800
Taargeett: folds 
buck17202394: folds 
Uncalled bet (800) returned to crazygal777
crazygal777 collected 3200 from pot
crazygal777: doesn't show hand 
*** SUMMARY ***
Total pot 3200 | Rake 0 
Board [Th 3c 7c]
Seat 1: Kopplin1 (small blind) folded before Flop
Seat 2: Taargeett (big blind) folded on the Flop
Seat 3: concorddeadi folded before Flop (didn't bet)
Seat 4: Gilmar735 folded before Flop (didn't bet)
Seat 5: A8tung folded before Flop (didn't bet)
Seat 6: PhxdB420 folded before Flop (didn't bet)
Seat 7: buck17202394 folded on the Flop
Seat 8: crazygal777 (button) collected (3200)



PokerStars Hand #201497534385: Tournament #2632284264, 17000+3000 Hold'em No Limit - Level XI (400/800) - 2019/06/17 22:31:43 ET
Table '2632284264 4' 9-max Seat #1 is the button
Seat 1: Kopplin1 (1500 in chips) 
Seat 2: Taargeett (3485 in chips) 
Seat 3: concorddeadi (12180 in chips) 
Seat 4: Gilmar735 (8127 in chips) 
Seat 5: A8tung (2255 in chips) 
Seat 6: PhxdB420 (11800 in chips) 
Seat 7: buck17202394 (12663 in chips) 
Seat 8: crazygal777 (15490 in chips) 
Kopplin1: posts the ante 50
Taargeett: posts the ante 50
concorddeadi: posts the ante 50
Gilmar735: posts the ante 50
A8tung: posts the ante 50
PhxdB420: posts the ante 50
buck17202394: posts the ante 50
crazygal777: posts the ante 50
Taargeett: posts small blind 400
concorddeadi: posts big blind 800
*** HOLE CARDS ***
Dealt to Taargeett [Jd 9c]
Gilmar735: folds 
A8tung: folds 
PhxdB420: raises 1600 to 2400
buck17202394: folds 
crazygal777: folds 
Kopplin1: folds 
Taargeett: folds 
concorddeadi: folds 
Uncalled bet (1600) returned to PhxdB420
PhxdB420 collected 2400 from pot
PhxdB420: doesn't show hand 
*** SUMMARY ***
Total pot 2400 | Rake 0 
Seat 1: Kopplin1 (button) folded before Flop (didn't bet)
Seat 2: Taargeett (small blind) folded before Flop
Seat 3: concorddeadi (big blind) folded before Flop
Seat 4: Gilmar735 folded before Flop (didn't bet)
Seat 5: A8tung folded before Flop (didn't bet)
Seat 6: PhxdB420 collected (2400)
Seat 7: buck17202394 folded before Flop (didn't bet)
Seat 8: crazygal777 folded before Flop (didn't bet)



PokerStars Hand #201497540362: Tournament #2632284264, 17000+3000 Hold'em No Limit - Level XI (400/800) - 2019/06/17 22:32:08 ET
Table '2632284264 4' 9-max Seat #2 is the button
Seat 1: Kopplin1 (1450 in chips) 
Seat 2: Taargeett (3035 in chips) 
Seat 3: concorddeadi (11330 in chips) 
Seat 4: Gilmar735 (8077 in chips) 
Seat 5: A8tung (2205 in chips) 
Seat 6: PhxdB420 (13350 in chips) 
Seat 7: buck17202394 (12613 in chips) 
Seat 8: crazygal777 (15440 in chips) 
Kopplin1: posts the ante 50
Taargeett: posts the ante 50
concorddeadi: posts the ante 50
Gilmar735: posts the ante 50
A8tung: posts the ante 50
PhxdB420: posts the ante 50
buck17202394: posts the ante 50
crazygal777: posts the ante 50
concorddeadi: posts small blind 400
Gilmar735: posts big blind 800
*** HOLE CARDS ***
Dealt to Taargeett [5h Jd]
A8tung: folds 
PhxdB420: folds 
buck17202394: calls 800
crazygal777: folds 
Kopplin1: folds 
Taargeett: folds 
concorddeadi: folds 
Gilmar735: checks 
*** FLOP *** [6d 4h 8s]
Gilmar735: checks 
buck17202394: checks 
*** TURN *** [6d 4h 8s] [Ks]
Gilmar735: checks 
buck17202394: checks 
*** RIVER *** [6d 4h 8s Ks] [As]
Gilmar735: bets 800
buck17202394: folds 
Uncalled bet (800) returned to Gilmar735
Gilmar735 collected 2400 from pot
*** SUMMARY ***
Total pot 2400 | Rake 0 
Board [6d 4h 8s Ks As]
Seat 1: Kopplin1 folded before Flop (didn't bet)
Seat 2: Taargeett (button) folded before Flop (didn't bet)
Seat 3: concorddeadi (small blind) folded before Flop
Seat 4: Gilmar735 (big blind) collected (2400)
Seat 5: A8tung folded before Flop (didn't bet)
Seat 6: PhxdB420 folded before Flop (didn't bet)
Seat 7: buck17202394 folded on the River
Seat 8: crazygal777 folded before Flop (didn't bet)



PokerStars Hand #201497552669: Tournament #2632284264, 17000+3000 Hold'em No Limit - Level XI (400/800) - 2019/06/17 22:33:01 ET
Table '2632284264 4' 9-max Seat #3 is the button
Seat 1: Kopplin1 (1400 in chips) 
Seat 2: Taargeett (2985 in chips) 
Seat 3: concorddeadi (10880 in chips) 
Seat 4: Gilmar735 (9627 in chips) 
Seat 5: A8tung (2155 in chips) 
Seat 6: PhxdB420 (13300 in chips) 
Seat 7: buck17202394 (11763 in chips) 
Seat 8: crazygal777 (15390 in chips) 
Kopplin1: posts the ante 50
Taargeett: posts the ante 50
concorddeadi: posts the ante 50
Gilmar735: posts the ante 50
A8tung: posts the ante 50
PhxdB420: posts the ante 50
buck17202394: posts the ante 50
crazygal777: posts the ante 50
Gilmar735: posts small blind 400
A8tung: posts big blind 800
*** HOLE CARDS ***
Dealt to Taargeett [3h 9c]
PhxdB420: folds 
buck17202394: folds 
crazygal777: folds 
Kopplin1: folds 
Taargeett: folds 
concorddeadi: folds 
Gilmar735: calls 400
A8tung: raises 1305 to 2105 and is all-in
Gilmar735: calls 1305
*** FLOP *** [2d 3s Ks]
*** TURN *** [2d 3s Ks] [Qc]
*** RIVER *** [2d 3s Ks Qc] [As]
*** SHOW DOWN ***
Gilmar735: shows [2c 6c] (a pair of Deuces)
A8tung: shows [Qh Jh] (a pair of Queens)
A8tung collected 4610 from pot
*** SUMMARY ***
Total pot 4610 | Rake 0 
Board [2d 3s Ks Qc As]
Seat 1: Kopplin1 folded before Flop (didn't bet)
Seat 2: Taargeett folded before Flop (didn't bet)
Seat 3: concorddeadi (button) folded before Flop (didn't bet)
Seat 4: Gilmar735 (small blind) showed [2c 6c] and lost with a pair of Deuces
Seat 5: A8tung (big blind) showed [Qh Jh] and won (4610) with a pair of Queens
Seat 6: PhxdB420 folded before Flop (didn't bet)
Seat 7: buck17202394 folded before Flop (didn't bet)
Seat 8: crazygal777 folded before Flop (didn't bet)



PokerStars Hand #201497563589: Tournament #2632284264, 17000+3000 Hold'em No Limit - Level XII (600/1200) - 2019/06/17 22:33:48 ET
Table '2632284264 4' 9-max Seat #4 is the button
Seat 1: Kopplin1 (1350 in chips) 
Seat 2: Taargeett (2935 in chips) 
Seat 3: concorddeadi (10830 in chips) 
Seat 4: Gilmar735 (7472 in chips) 
Seat 5: A8tung (4610 in chips) 
Seat 6: PhxdB420 (13250 in chips) 
Seat 7: buck17202394 (11713 in chips) 
Seat 8: crazygal777 (15340 in chips) 
Kopplin1: posts the ante 75
Taargeett: posts the ante 75
concorddeadi: posts the ante 75
Gilmar735: posts the ante 75
A8tung: posts the ante 75
PhxdB420: posts the ante 75
buck17202394: posts the ante 75
crazygal777: posts the ante 75
A8tung: posts small blind 600
PhxdB420: posts big blind 1200
*** HOLE CARDS ***
Dealt to Taargeett [9s 6c]
buck17202394: folds 
crazygal777: folds 
Kopplin1: folds 
Taargeett: folds 
concorddeadi: folds 
Gilmar735: folds 
A8tung: raises 3335 to 4535 and is all-in
PhxdB420: folds 
Uncalled bet (3335) returned to A8tung
A8tung collected 3000 from pot
*** SUMMARY ***
Total pot 3000 | Rake 0 
Seat 1: Kopplin1 folded before Flop (didn't bet)
Seat 2: Taargeett folded before Flop (didn't bet)
Seat 3: concorddeadi folded before Flop (didn't bet)
Seat 4: Gilmar735 (button) folded before Flop (didn't bet)
Seat 5: A8tung (small blind) collected (3000)
Seat 6: PhxdB420 (big blind) folded before Flop
Seat 7: buck17202394 folded before Flop (didn't bet)
Seat 8: crazygal777 folded before Flop (didn't bet)



PokerStars Hand #201497572591: Tournament #2632284264, 17000+3000 Hold'em No Limit - Level XII (600/1200) - 2019/06/17 22:34:28 ET
Table '2632284264 4' 9-max Seat #5 is the button
Seat 1: Kopplin1 (1275 in chips) 
Seat 2: Taargeett (2860 in chips) 
Seat 3: concorddeadi (10755 in chips) 
Seat 4: Gilmar735 (7397 in chips) 
Seat 5: A8tung (6335 in chips) 
Seat 6: PhxdB420 (11975 in chips) 
Seat 7: buck17202394 (11638 in chips) 
Seat 8: crazygal777 (15265 in chips) 
Kopplin1: posts the ante 75
Taargeett: posts the ante 75
concorddeadi: posts the ante 75
Gilmar735: posts the ante 75
A8tung: posts the ante 75
PhxdB420: posts the ante 75
buck17202394: posts the ante 75
crazygal777: posts the ante 75
PhxdB420: posts small blind 600
buck17202394: posts big blind 1200
*** HOLE CARDS ***
Dealt to Taargeett [2h 8s]
crazygal777: folds 
Kopplin1: folds 
Taargeett: folds 
concorddeadi: folds 
Gilmar735: calls 1200
A8tung: folds 
PhxdB420: raises 2400 to 3600
buck17202394: calls 2400
Gilmar735: calls 2400
*** FLOP *** [6d 8h Ts]
PhxdB420: bets 5700
buck17202394: folds 
Gilmar735: calls 3722 and is all-in
Uncalled bet (1978) returned to PhxdB420
*** TURN *** [6d 8h Ts] [2s]
*** RIVER *** [6d 8h Ts 2s] [4d]
*** SHOW DOWN ***
PhxdB420: shows [Qs Js] (high card Queen)
Gilmar735: shows [Td Kh] (a pair of Tens)
Gilmar735 collected 18844 from pot
*** SUMMARY ***
Total pot 18844 | Rake 0 
Board [6d 8h Ts 2s 4d]
Seat 1: Kopplin1 folded before Flop (didn't bet)
Seat 2: Taargeett folded before Flop (didn't bet)
Seat 3: concorddeadi folded before Flop (didn't bet)
Seat 4: Gilmar735 showed [Td Kh] and won (18844) with a pair of Tens
Seat 5: A8tung (button) folded before Flop (didn't bet)
Seat 6: PhxdB420 (small blind) showed [Qs Js] and lost with high card Queen
Seat 7: buck17202394 (big blind) folded on the Flop
Seat 8: crazygal777 folded before Flop (didn't bet)



PokerStars Hand #201497587095: Tournament #2632284264, 17000+3000 Hold'em No Limit - Level XII (600/1200) - 2019/06/17 22:35:30 ET
Table '2632284264 4' 9-max Seat #6 is the button
Seat 1: Kopplin1 (1200 in chips) 
Seat 2: Taargeett (2785 in chips) 
Seat 3: concorddeadi (10680 in chips) 
Seat 4: Gilmar735 (18844 in chips) 
Seat 5: A8tung (6260 in chips) 
Seat 6: PhxdB420 (4578 in chips) 
Seat 7: buck17202394 (7963 in chips) 
Seat 8: crazygal777 (15190 in chips) 
Kopplin1: posts the ante 75
Taargeett: posts the ante 75
concorddeadi: posts the ante 75
Gilmar735: posts the ante 75
A8tung: posts the ante 75
PhxdB420: posts the ante 75
buck17202394: posts the ante 75
crazygal777: posts the ante 75
buck17202394: posts small blind 600
crazygal777: posts big blind 1200
*** HOLE CARDS ***
Dealt to Taargeett [3h 4s]
Kopplin1: calls 1125 and is all-in
Taargeett: folds 
concorddeadi: folds 
Gilmar735: folds 
A8tung: folds 
PhxdB420: folds 
buck17202394: calls 600
crazygal777: checks 
*** FLOP *** [5s 7s 3c]
buck17202394: checks 
crazygal777: checks 
*** TURN *** [5s 7s 3c] [6d]
buck17202394: checks 
crazygal777: checks 
*** RIVER *** [5s 7s 3c 6d] [8d]
buck17202394: checks 
crazygal777: checks 
*** SHOW DOWN ***
buck17202394: shows [2c Ac] (high card Ace)
crazygal777: shows [2h 7c] (a pair of Sevens)
crazygal777 collected 150 from side pot
Kopplin1: mucks hand 
crazygal777 collected 3975 from main pot
Kopplin1 finished the tournament in 8th place
*** SUMMARY ***
Total pot 4125 Main pot 3975. Side pot 150. | Rake 0 
Board [5s 7s 3c 6d 8d]
Seat 1: Kopplin1 mucked [Ts Kd]
Seat 2: Taargeett folded before Flop (didn't bet)
Seat 3: concorddeadi folded before Flop (didn't bet)
Seat 4: Gilmar735 folded before Flop (didn't bet)
Seat 5: A8tung folded before Flop (didn't bet)
Seat 6: PhxdB420 (button) folded before Flop (didn't bet)
Seat 7: buck17202394 (small blind) showed [2c Ac] and lost with high card Ace
Seat 8: crazygal777 (big blind) showed [2h 7c] and won (4125) with a pair of Sevens



PokerStars Hand #201497595979: Tournament #2632284264, 17000+3000 Hold'em No Limit - Level XII (600/1200) - 2019/06/17 22:36:09 ET
Table '2632284264 4' 9-max Seat #7 is the button
Seat 2: Taargeett (2710 in chips) 
Seat 3: concorddeadi (10605 in chips) 
Seat 4: Gilmar735 (18769 in chips) 
Seat 5: A8tung (6185 in chips) 
Seat 6: PhxdB420 (4503 in chips) 
Seat 7: buck17202394 (6688 in chips) 
Seat 8: crazygal777 (18040 in chips) 
Taargeett: posts the ante 75
concorddeadi: posts the ante 75
Gilmar735: posts the ante 75
A8tung: posts the ante 75
PhxdB420: posts the ante 75
buck17202394: posts the ante 75
crazygal777: posts the ante 75
crazygal777: posts small blind 600
Taargeett: posts big blind 1200
*** HOLE CARDS ***
Dealt to Taargeett [Kd 3s]
concorddeadi: folds 
Gilmar735: folds 
A8tung: raises 1200 to 2400
PhxdB420: folds 
buck17202394: folds 
crazygal777: folds 
Taargeett: raises 235 to 2635 and is all-in
A8tung: calls 235
*** FLOP *** [8h 5s Th]
*** TURN *** [8h 5s Th] [As]
*** RIVER *** [8h 5s Th As] [7s]
*** SHOW DOWN ***
Taargeett: shows [Kd 3s] (high card Ace)
A8tung: shows [Jd Jc] (a pair of Jacks)
A8tung collected 6395 from pot
Taargeett finished the tournament in 7th place and received 26775.00.
*** SUMMARY ***
Total pot 6395 | Rake 0 
Board [8h 5s Th As 7s]
Seat 2: Taargeett (big blind) showed [Kd 3s] and lost with high card Ace
Seat 3: concorddeadi folded before Flop (didn't bet)
Seat 4: Gilmar735 folded before Flop (didn't bet)
Seat 5: A8tung showed [Jd Jc] and won (6395) with a pair of Jacks
Seat 6: PhxdB420 folded before Flop (didn't bet)
Seat 7: buck17202394 (button) folded before Flop (didn't bet)
Seat 8: crazygal777 (small blind) folded before Flop



