PokerStars Hand #201795747797: Tournament #2638521358, $0.23+$0.02 USD Hold'em No Limit - Level I (10/20) - 2019/06/27 18:46:59 ET
Table '2638521358 3' 9-max Seat #1 is the button
Seat 1: Taargeett (1500 in chips) 
Seat 2: drope$tyle (1500 in chips) 
Seat 3: BrSerafim (1500 in chips) 
Seat 4: ROBSONSMV22 (1500 in chips) 
Seat 5: DouglasFReis (1500 in chips) 
Seat 6: Mr.Jerf (1500 in chips) 
Seat 7: Phteev (1500 in chips) 
Seat 8: SULIMA712 (1500 in chips) 
Seat 9: urubudabad (1500 in chips) 
Taargeett: posts the ante 3
drope$tyle: posts the ante 3
BrSerafim: posts the ante 3
ROBSONSMV22: posts the ante 3
DouglasFReis: posts the ante 3
Mr.Jerf: posts the ante 3
Phteev: posts the ante 3
SULIMA712: posts the ante 3
urubudabad: posts the ante 3
drope$tyle: posts small blind 10
BrSerafim: posts big blind 20
*** HOLE CARDS ***
Dealt to Taargeett [5s 7d]
ROBSONSMV22: calls 20
DouglasFReis: raises 60 to 80
Mr.Jerf: folds 
Phteev: folds 
SULIMA712: folds 
urubudabad: folds 
Taargeett: folds 
drope$tyle: calls 70
BrSerafim: folds 
ROBSONSMV22: calls 60
*** FLOP *** [2d 5d Jd]
drope$tyle: bets 20
ROBSONSMV22: raises 327 to 347
DouglasFReis: folds 
drope$tyle: calls 327
*** TURN *** [2d 5d Jd] [Qh]
drope$tyle: checks 
ROBSONSMV22: checks 
*** RIVER *** [2d 5d Jd Qh] [4d]
drope$tyle: checks 
ROBSONSMV22: bets 491
drope$tyle: folds 
Uncalled bet (491) returned to ROBSONSMV22
ROBSONSMV22 collected 981 from pot
ROBSONSMV22: shows [Js 2h] (two pair, Jacks and Deuces)
*** SUMMARY ***
Total pot 981 | Rake 0 
Board [2d 5d Jd Qh 4d]
Seat 1: Taargeett (button) folded before Flop (didn't bet)
Seat 2: drope$tyle (small blind) folded on the River
Seat 3: BrSerafim (big blind) folded before Flop
Seat 4: ROBSONSMV22 collected (981)
Seat 5: DouglasFReis folded on the Flop
Seat 6: Mr.Jerf folded before Flop (didn't bet)
Seat 7: Phteev folded before Flop (didn't bet)
Seat 8: SULIMA712 folded before Flop (didn't bet)
Seat 9: urubudabad folded before Flop (didn't bet)



PokerStars Hand #201795780224: Tournament #2638521358, $0.23+$0.02 USD Hold'em No Limit - Level I (10/20) - 2019/06/27 18:48:12 ET
Table '2638521358 3' 9-max Seat #2 is the button
Seat 1: Taargeett (1497 in chips) 
Seat 2: drope$tyle (1070 in chips) 
Seat 3: BrSerafim (1477 in chips) 
Seat 4: ROBSONSMV22 (2051 in chips) 
Seat 5: DouglasFReis (1417 in chips) 
Seat 6: Mr.Jerf (1497 in chips) 
Seat 7: Phteev (1497 in chips) 
Seat 8: SULIMA712 (1497 in chips) 
Seat 9: urubudabad (1497 in chips) 
Taargeett: posts the ante 3
drope$tyle: posts the ante 3
BrSerafim: posts the ante 3
ROBSONSMV22: posts the ante 3
DouglasFReis: posts the ante 3
Mr.Jerf: posts the ante 3
Phteev: posts the ante 3
SULIMA712: posts the ante 3
urubudabad: posts the ante 3
BrSerafim: posts small blind 10
ROBSONSMV22: posts big blind 20
*** HOLE CARDS ***
Dealt to Taargeett [4c 3d]
DouglasFReis: raises 40 to 60
Mr.Jerf has timed out
Mr.Jerf: folds 
Mr.Jerf is sitting out
Phteev: folds 
SULIMA712: raises 40 to 100
urubudabad: folds 
Taargeett: folds 
drope$tyle: folds 
BrSerafim: folds 
ROBSONSMV22: calls 80
DouglasFReis: raises 340 to 440
SULIMA712: folds 
ROBSONSMV22: calls 340
*** FLOP *** [9s 6s 5d]
ROBSONSMV22: checks 
DouglasFReis: bets 678
ROBSONSMV22: raises 930 to 1608 and is all-in
DouglasFReis: calls 296 and is all-in
Uncalled bet (634) returned to ROBSONSMV22
*** TURN *** [9s 6s 5d] [Jc]
*** RIVER *** [9s 6s 5d Jc] [Qh]
*** SHOW DOWN ***
ROBSONSMV22: shows [Qs Kh] (a pair of Queens)
DouglasFReis: shows [Kc Ks] (a pair of Kings)
DouglasFReis collected 2965 from pot
*** SUMMARY ***
Total pot 2965 | Rake 0 
Board [9s 6s 5d Jc Qh]
Seat 1: Taargeett folded before Flop (didn't bet)
Seat 2: drope$tyle (button) folded before Flop (didn't bet)
Seat 3: BrSerafim (small blind) folded before Flop
Seat 4: ROBSONSMV22 (big blind) showed [Qs Kh] and lost with a pair of Queens
Seat 5: DouglasFReis showed [Kc Ks] and won (2965) with a pair of Kings
Seat 6: Mr.Jerf folded before Flop (didn't bet)
Seat 7: Phteev folded before Flop (didn't bet)
Seat 8: SULIMA712 folded before Flop
Seat 9: urubudabad folded before Flop (didn't bet)



PokerStars Hand #201795837297: Tournament #2638521358, $0.23+$0.02 USD Hold'em No Limit - Level I (10/20) - 2019/06/27 18:50:20 ET
Table '2638521358 3' 9-max Seat #3 is the button
Seat 1: Taargeett (1494 in chips) 
Seat 2: drope$tyle (1067 in chips) 
Seat 3: BrSerafim (1464 in chips) 
Seat 4: ROBSONSMV22 (634 in chips) 
Seat 5: DouglasFReis (2965 in chips) 
Seat 6: Mr.Jerf (1494 in chips) is sitting out
Seat 7: Phteev (1494 in chips) 
Seat 8: SULIMA712 (1394 in chips) 
Seat 9: urubudabad (1494 in chips) 
Taargeett: posts the ante 3
drope$tyle: posts the ante 3
BrSerafim: posts the ante 3
ROBSONSMV22: posts the ante 3
DouglasFReis: posts the ante 3
Mr.Jerf: posts the ante 3
Phteev: posts the ante 3
SULIMA712: posts the ante 3
urubudabad: posts the ante 3
ROBSONSMV22: posts small blind 10
DouglasFReis: posts big blind 20
*** HOLE CARDS ***
Dealt to Taargeett [Jc Ac]
Mr.Jerf: folds 
Phteev: folds 
SULIMA712 is disconnected 
SULIMA712 has timed out while disconnected
SULIMA712: folds 
SULIMA712 is sitting out
urubudabad: folds 
Taargeett: raises 30 to 50
drope$tyle: raises 1014 to 1064 and is all-in
BrSerafim: folds 
ROBSONSMV22: folds 
Mr.Jerf has returned
DouglasFReis: folds 
Taargeett: calls 1014
*** FLOP *** [Td 5h Jh]
*** TURN *** [Td 5h Jh] [3d]
*** RIVER *** [Td 5h Jh 3d] [Tc]
*** SHOW DOWN ***
Taargeett: shows [Jc Ac] (two pair, Jacks and Tens)
drope$tyle: shows [Ks Kh] (two pair, Kings and Tens)
drope$tyle collected 2185 from pot
*** SUMMARY ***
Total pot 2185 | Rake 0 
Board [Td 5h Jh 3d Tc]
Seat 1: Taargeett showed [Jc Ac] and lost with two pair, Jacks and Tens
Seat 2: drope$tyle showed [Ks Kh] and won (2185) with two pair, Kings and Tens
Seat 3: BrSerafim (button) folded before Flop (didn't bet)
Seat 4: ROBSONSMV22 (small blind) folded before Flop
Seat 5: DouglasFReis (big blind) folded before Flop
Seat 6: Mr.Jerf folded before Flop (didn't bet)
Seat 7: Phteev folded before Flop (didn't bet)
Seat 8: SULIMA712 folded before Flop (didn't bet)
Seat 9: urubudabad folded before Flop (didn't bet)



PokerStars Hand #201795886977: Tournament #2638521358, $0.23+$0.02 USD Hold'em No Limit - Level I (10/20) - 2019/06/27 18:52:13 ET
Table '2638521358 3' 9-max Seat #4 is the button
Seat 1: Taargeett (427 in chips) 
Seat 2: drope$tyle (2185 in chips) 
Seat 3: BrSerafim (1461 in chips) 
Seat 4: ROBSONSMV22 (621 in chips) 
Seat 5: DouglasFReis (2942 in chips) 
Seat 6: Mr.Jerf (1491 in chips) 
Seat 7: Phteev (1491 in chips) 
Seat 8: SULIMA712 (1391 in chips) is sitting out
Seat 9: urubudabad (1491 in chips) 
Taargeett: posts the ante 3
drope$tyle: posts the ante 3
BrSerafim: posts the ante 3
ROBSONSMV22: posts the ante 3
DouglasFReis: posts the ante 3
Mr.Jerf: posts the ante 3
Phteev: posts the ante 3
SULIMA712: posts the ante 3
urubudabad: posts the ante 3
DouglasFReis: posts small blind 10
Mr.Jerf: posts big blind 20
*** HOLE CARDS ***
Dealt to Taargeett [2d Th]
Phteev: folds 
SULIMA712: folds 
urubudabad: folds 
Taargeett: folds 
drope$tyle: folds 
BrSerafim: raises 40 to 60
ROBSONSMV22: calls 60
DouglasFReis: folds 
Mr.Jerf: folds 
*** FLOP *** [6h Ac 9c]
BrSerafim: bets 89
ROBSONSMV22: calls 89
*** TURN *** [6h Ac 9c] [Ah]
BrSerafim: checks 
SULIMA712 has returned
ROBSONSMV22: bets 469 and is all-in
BrSerafim: folds 
Uncalled bet (469) returned to ROBSONSMV22
ROBSONSMV22 collected 355 from pot
ROBSONSMV22: doesn't show hand 
*** SUMMARY ***
Total pot 355 | Rake 0 
Board [6h Ac 9c Ah]
Seat 1: Taargeett folded before Flop (didn't bet)
Seat 2: drope$tyle folded before Flop (didn't bet)
Seat 3: BrSerafim folded on the Turn
Seat 4: ROBSONSMV22 (button) collected (355)
Seat 5: DouglasFReis (small blind) folded before Flop
Seat 6: Mr.Jerf (big blind) folded before Flop
Seat 7: Phteev folded before Flop (didn't bet)
Seat 8: SULIMA712 folded before Flop (didn't bet)
Seat 9: urubudabad folded before Flop (didn't bet)



PokerStars Hand #201795907355: Tournament #2638521358, $0.23+$0.02 USD Hold'em No Limit - Level I (10/20) - 2019/06/27 18:53:00 ET
Table '2638521358 3' 9-max Seat #5 is the button
Seat 1: Taargeett (424 in chips) 
Seat 2: drope$tyle (2182 in chips) 
Seat 3: BrSerafim (1309 in chips) 
Seat 4: ROBSONSMV22 (824 in chips) 
Seat 5: DouglasFReis (2929 in chips) 
Seat 6: Mr.Jerf (1468 in chips) 
Seat 7: Phteev (1488 in chips) 
Seat 8: SULIMA712 (1388 in chips) 
Seat 9: urubudabad (1488 in chips) 
Taargeett: posts the ante 3
drope$tyle: posts the ante 3
BrSerafim: posts the ante 3
ROBSONSMV22: posts the ante 3
DouglasFReis: posts the ante 3
Mr.Jerf: posts the ante 3
Phteev: posts the ante 3
SULIMA712: posts the ante 3
urubudabad: posts the ante 3
Mr.Jerf: posts small blind 10
Phteev: posts big blind 20
*** HOLE CARDS ***
Dealt to Taargeett [2h Ts]
SULIMA712: folds 
urubudabad: folds 
Taargeett: folds 
drope$tyle: raises 2159 to 2179 and is all-in
BrSerafim: folds 
ROBSONSMV22: folds 
DouglasFReis: folds 
Mr.Jerf: folds 
Phteev: folds 
Uncalled bet (2159) returned to drope$tyle
drope$tyle collected 77 from pot
drope$tyle: doesn't show hand 
*** SUMMARY ***
Total pot 77 | Rake 0 
Seat 1: Taargeett folded before Flop (didn't bet)
Seat 2: drope$tyle collected (77)
Seat 3: BrSerafim folded before Flop (didn't bet)
Seat 4: ROBSONSMV22 folded before Flop (didn't bet)
Seat 5: DouglasFReis (button) folded before Flop (didn't bet)
Seat 6: Mr.Jerf (small blind) folded before Flop
Seat 7: Phteev (big blind) folded before Flop
Seat 8: SULIMA712 folded before Flop (didn't bet)
Seat 9: urubudabad folded before Flop (didn't bet)



PokerStars Hand #201795917838: Tournament #2638521358, $0.23+$0.02 USD Hold'em No Limit - Level I (10/20) - 2019/06/27 18:53:24 ET
Table '2638521358 3' 9-max Seat #6 is the button
Seat 1: Taargeett (421 in chips) 
Seat 2: drope$tyle (2236 in chips) 
Seat 3: BrSerafim (1306 in chips) 
Seat 4: ROBSONSMV22 (821 in chips) 
Seat 5: DouglasFReis (2926 in chips) 
Seat 6: Mr.Jerf (1455 in chips) 
Seat 7: Phteev (1465 in chips) 
Seat 8: SULIMA712 (1385 in chips) 
Seat 9: urubudabad (1485 in chips) 
Taargeett: posts the ante 3
drope$tyle: posts the ante 3
BrSerafim: posts the ante 3
ROBSONSMV22: posts the ante 3
DouglasFReis: posts the ante 3
Mr.Jerf: posts the ante 3
Phteev: posts the ante 3
SULIMA712: posts the ante 3
urubudabad: posts the ante 3
Phteev: posts small blind 10
SULIMA712: posts big blind 20
*** HOLE CARDS ***
Dealt to Taargeett [3h 5c]
urubudabad: folds 
Taargeett: folds 
drope$tyle: calls 20
BrSerafim: folds 
ROBSONSMV22: folds 
DouglasFReis: folds 
Mr.Jerf: raises 80 to 100
Phteev: folds 
SULIMA712: calls 80
drope$tyle: calls 80
*** FLOP *** [5h As Td]
SULIMA712: checks 
drope$tyle: bets 60
Mr.Jerf: calls 60
SULIMA712: folds 
*** TURN *** [5h As Td] [6h]
drope$tyle: bets 2073 and is all-in
Mr.Jerf: folds 
Uncalled bet (2073) returned to drope$tyle
drope$tyle collected 457 from pot
drope$tyle: doesn't show hand 
*** SUMMARY ***
Total pot 457 | Rake 0 
Board [5h As Td 6h]
Seat 1: Taargeett folded before Flop (didn't bet)
Seat 2: drope$tyle collected (457)
Seat 3: BrSerafim folded before Flop (didn't bet)
Seat 4: ROBSONSMV22 folded before Flop (didn't bet)
Seat 5: DouglasFReis folded before Flop (didn't bet)
Seat 6: Mr.Jerf (button) folded on the Turn
Seat 7: Phteev (small blind) folded before Flop
Seat 8: SULIMA712 (big blind) folded on the Flop
Seat 9: urubudabad folded before Flop (didn't bet)



PokerStars Hand #201795944180: Tournament #2638521358, $0.23+$0.02 USD Hold'em No Limit - Level I (10/20) - 2019/06/27 18:54:25 ET
Table '2638521358 3' 9-max Seat #7 is the button
Seat 1: Taargeett (418 in chips) 
Seat 2: drope$tyle (2530 in chips) 
Seat 3: BrSerafim (1303 in chips) 
Seat 4: ROBSONSMV22 (818 in chips) 
Seat 5: DouglasFReis (2923 in chips) 
Seat 6: Mr.Jerf (1292 in chips) 
Seat 7: Phteev (1452 in chips) 
Seat 8: SULIMA712 (1282 in chips) 
Seat 9: urubudabad (1482 in chips) 
Taargeett: posts the ante 3
drope$tyle: posts the ante 3
BrSerafim: posts the ante 3
ROBSONSMV22: posts the ante 3
DouglasFReis: posts the ante 3
Mr.Jerf: posts the ante 3
Phteev: posts the ante 3
SULIMA712: posts the ante 3
urubudabad: posts the ante 3
SULIMA712: posts small blind 10
urubudabad: posts big blind 20
*** HOLE CARDS ***
Dealt to Taargeett [8c 2c]
Taargeett: folds 
drope$tyle: calls 20
BrSerafim: folds 
ROBSONSMV22: calls 20
DouglasFReis: folds 
Mr.Jerf: folds 
Phteev: raises 40 to 60
SULIMA712: folds 
urubudabad: calls 40
drope$tyle: calls 40
ROBSONSMV22: calls 40
*** FLOP *** [3h 3d As]
urubudabad: checks 
drope$tyle: bets 80
ROBSONSMV22: raises 675 to 755 and is all-in
Phteev: folds 
urubudabad: folds 
drope$tyle: calls 675
BrSerafim is sitting out
*** TURN *** [3h 3d As] [9s]
*** RIVER *** [3h 3d As 9s] [6h]
*** SHOW DOWN ***
drope$tyle: shows [Ac 7s] (two pair, Aces and Threes)
ROBSONSMV22: shows [8h 5c] (a pair of Threes)
drope$tyle collected 1787 from pot
ROBSONSMV22 finished the tournament in 44th place
*** SUMMARY ***
Total pot 1787 | Rake 0 
Board [3h 3d As 9s 6h]
Seat 1: Taargeett folded before Flop (didn't bet)
Seat 2: drope$tyle showed [Ac 7s] and won (1787) with two pair, Aces and Threes
Seat 3: BrSerafim folded before Flop (didn't bet)
Seat 4: ROBSONSMV22 showed [8h 5c] and lost with a pair of Threes
Seat 5: DouglasFReis folded before Flop (didn't bet)
Seat 6: Mr.Jerf folded before Flop (didn't bet)
Seat 7: Phteev (button) folded on the Flop
Seat 8: SULIMA712 (small blind) folded before Flop
Seat 9: urubudabad (big blind) folded on the Flop



