PokerStars Hand #201224710049: Tournament #2620370251, 8700+1300 Hold'em No Limit - Level I (10/20) - 2019/06/09 11:05:00 ET
Table '2620370251 1' 9-max Seat #1 is the button
Seat 1: Dallas433 (1500 in chips) 
Seat 2: cant_remembr (1500 in chips) 
Seat 3: DGOKER577 (1500 in chips) 
Seat 4: igorrns (1500 in chips) 
Seat 5: Mifa81 (1500 in chips) 
Seat 6: Dagregetan (1500 in chips) 
Seat 7: wolfxx61 (1500 in chips) 
Seat 8: Taargeett (1500 in chips) 
Seat 9: turtlemania1B (1500 in chips) is sitting out
cant_remembr: posts small blind 10
DGOKER577: posts big blind 20
*** HOLE CARDS ***
Dealt to Taargeett [Jc 9d]
igorrns: folds 
Mifa81: calls 20
Dagregetan: folds 
wolfxx61: folds 
Taargeett: folds 
turtlemania1B: folds 
Dallas433: folds 
cant_remembr: calls 10
DGOKER577: checks 
*** FLOP *** [Ks 7d 9c]
cant_remembr: checks 
DGOKER577: checks 
Mifa81: checks 
*** TURN *** [Ks 7d 9c] [Kc]
cant_remembr: checks 
DGOKER577: bets 40
Mifa81: folds 
cant_remembr: folds 
Uncalled bet (40) returned to DGOKER577
DGOKER577 collected 60 from pot
*** SUMMARY ***
Total pot 60 | Rake 0 
Board [Ks 7d 9c Kc]
Seat 1: Dallas433 (button) folded before Flop (didn't bet)
Seat 2: cant_remembr (small blind) folded on the Turn
Seat 3: DGOKER577 (big blind) collected (60)
Seat 4: igorrns folded before Flop (didn't bet)
Seat 5: Mifa81 folded on the Turn
Seat 6: Dagregetan folded before Flop (didn't bet)
Seat 7: wolfxx61 folded before Flop (didn't bet)
Seat 8: Taargeett folded before Flop (didn't bet)
Seat 9: turtlemania1B folded before Flop (didn't bet)



PokerStars Hand #201224733545: Tournament #2620370251, 8700+1300 Hold'em No Limit - Level I (10/20) - 2019/06/09 11:05:45 ET
Table '2620370251 1' 9-max Seat #2 is the button
Seat 1: Dallas433 (1500 in chips) 
Seat 2: cant_remembr (1480 in chips) 
Seat 3: DGOKER577 (1540 in chips) 
Seat 4: igorrns (1500 in chips) 
Seat 6: Dagregetan (1500 in chips) 
Seat 7: wolfxx61 (1500 in chips) is sitting out
Seat 8: Taargeett (1500 in chips) 
Seat 9: turtlemania1B (1500 in chips) is sitting out
DGOKER577: posts small blind 10
igorrns: posts big blind 20
*** HOLE CARDS ***
Dealt to Taargeett [4c 8d]
Dagregetan: folds 
wolfxx61: folds 
Taargeett: folds 
turtlemania1B: folds 
Dallas433: folds 
cant_remembr: folds 
DGOKER577: calls 10
igorrns: checks 
*** FLOP *** [6c Jd 6d]
DGOKER577: checks 
igorrns: checks 
*** TURN *** [6c Jd 6d] [3h]
DGOKER577: checks 
igorrns: checks 
*** RIVER *** [6c Jd 6d 3h] [2d]
DGOKER577: checks 
igorrns: checks 
*** SHOW DOWN ***
DGOKER577: shows [9s 8h] (a pair of Sixes)
igorrns: shows [4d Jh] (two pair, Jacks and Sixes)
igorrns collected 40 from pot
*** SUMMARY ***
Total pot 40 | Rake 0 
Board [6c Jd 6d 3h 2d]
Seat 1: Dallas433 folded before Flop (didn't bet)
Seat 2: cant_remembr (button) folded before Flop (didn't bet)
Seat 3: DGOKER577 (small blind) showed [9s 8h] and lost with a pair of Sixes
Seat 4: igorrns (big blind) showed [4d Jh] and won (40) with two pair, Jacks and Sixes
Seat 6: Dagregetan folded before Flop (didn't bet)
Seat 7: wolfxx61 folded before Flop (didn't bet)
Seat 8: Taargeett folded before Flop (didn't bet)
Seat 9: turtlemania1B folded before Flop (didn't bet)



PokerStars Hand #201224758100: Tournament #2620370251, 8700+1300 Hold'em No Limit - Level I (10/20) - 2019/06/09 11:06:33 ET
Table '2620370251 1' 9-max Seat #3 is the button
Seat 1: Dallas433 (1500 in chips) 
Seat 2: cant_remembr (1480 in chips) 
Seat 3: DGOKER577 (1520 in chips) 
Seat 4: igorrns (1520 in chips) 
Seat 5: chaggi23 (1500 in chips) 
Seat 6: Dagregetan (1500 in chips) 
Seat 7: wolfxx61 (1500 in chips) is sitting out
Seat 8: Taargeett (1500 in chips) 
Seat 9: turtlemania1B (1500 in chips) 
igorrns: posts small blind 10
chaggi23: posts big blind 20
*** HOLE CARDS ***
Dealt to Taargeett [7h Th]
Dagregetan: folds 
wolfxx61: folds 
Taargeett: raises 40 to 60
turtlemania1B has timed out
turtlemania1B: folds 
Dallas433: folds 
cant_remembr: folds 
DGOKER577: folds 
igorrns: raises 1460 to 1520 and is all-in
chaggi23: folds 
Taargeett: folds 
Uncalled bet (1460) returned to igorrns
igorrns collected 140 from pot
igorrns: doesn't show hand 
*** SUMMARY ***
Total pot 140 | Rake 0 
Seat 1: Dallas433 folded before Flop (didn't bet)
Seat 2: cant_remembr folded before Flop (didn't bet)
Seat 3: DGOKER577 (button) folded before Flop (didn't bet)
Seat 4: igorrns (small blind) collected (140)
Seat 5: chaggi23 (big blind) folded before Flop
Seat 6: Dagregetan folded before Flop (didn't bet)
Seat 7: wolfxx61 folded before Flop (didn't bet)
Seat 8: Taargeett folded before Flop
Seat 9: turtlemania1B folded before Flop (didn't bet)



PokerStars Hand #201224780576: Tournament #2620370251, 8700+1300 Hold'em No Limit - Level I (10/20) - 2019/06/09 11:07:15 ET
Table '2620370251 1' 9-max Seat #4 is the button
Seat 1: Dallas433 (1500 in chips) 
Seat 2: cant_remembr (1480 in chips) 
Seat 3: DGOKER577 (1520 in chips) 
Seat 4: igorrns (1600 in chips) 
Seat 5: chaggi23 (1480 in chips) 
Seat 7: wolfxx61 (1500 in chips) is sitting out
Seat 8: Taargeett (1440 in chips) 
Seat 9: turtlemania1B (1500 in chips) is sitting out
chaggi23: posts small blind 10
wolfxx61: posts big blind 20
*** HOLE CARDS ***
Dealt to Taargeett [6d 7c]
Taargeett: folds 
turtlemania1B: folds 
Dallas433: folds 
cant_remembr: folds 
DGOKER577: folds 
igorrns: raises 1580 to 1600 and is all-in
chaggi23: folds 
wolfxx61: folds 
Uncalled bet (1580) returned to igorrns
igorrns collected 50 from pot
igorrns: doesn't show hand 
*** SUMMARY ***
Total pot 50 | Rake 0 
Seat 1: Dallas433 folded before Flop (didn't bet)
Seat 2: cant_remembr folded before Flop (didn't bet)
Seat 3: DGOKER577 folded before Flop (didn't bet)
Seat 4: igorrns (button) collected (50)
Seat 5: chaggi23 (small blind) folded before Flop
Seat 7: wolfxx61 (big blind) folded before Flop
Seat 8: Taargeett folded before Flop (didn't bet)
Seat 9: turtlemania1B folded before Flop (didn't bet)



PokerStars Hand #201224799405: Tournament #2620370251, 8700+1300 Hold'em No Limit - Level I (10/20) - 2019/06/09 11:07:51 ET
Table '2620370251 1' 9-max Seat #5 is the button
Seat 1: Dallas433 (1500 in chips) 
Seat 2: cant_remembr (1480 in chips) 
Seat 3: DGOKER577 (1520 in chips) 
Seat 4: igorrns (1630 in chips) 
Seat 5: chaggi23 (1470 in chips) 
Seat 6: Albtraum72 (1500 in chips) out of hand (moved from another table into small blind)
Seat 7: wolfxx61 (1480 in chips) is sitting out
Seat 8: Taargeett (1440 in chips) 
Seat 9: turtlemania1B (1500 in chips) 
Albtraum72 will be allowed to play after the button
wolfxx61: posts small blind 10
Taargeett: posts big blind 20
*** HOLE CARDS ***
Dealt to Taargeett [Qh 6d]
turtlemania1B: calls 20
Dallas433: folds 
cant_remembr: folds 
DGOKER577: calls 20
igorrns: folds 
chaggi23: folds 
wolfxx61: folds 
Taargeett: checks 
*** FLOP *** [6h Ac 5c]
Taargeett: checks 
turtlemania1B: checks 
DGOKER577: bets 20
Taargeett: folds 
turtlemania1B: calls 20
*** TURN *** [6h Ac 5c] [7c]
turtlemania1B: checks 
DGOKER577: bets 20
turtlemania1B: calls 20
*** RIVER *** [6h Ac 5c 7c] [7d]
turtlemania1B: checks 
DGOKER577: bets 100
turtlemania1B: folds 
Uncalled bet (100) returned to DGOKER577
DGOKER577 collected 150 from pot
*** SUMMARY ***
Total pot 150 | Rake 0 
Board [6h Ac 5c 7c 7d]
Seat 1: Dallas433 folded before Flop (didn't bet)
Seat 2: cant_remembr folded before Flop (didn't bet)
Seat 3: DGOKER577 collected (150)
Seat 4: igorrns folded before Flop (didn't bet)
Seat 5: chaggi23 (button) folded before Flop (didn't bet)
Seat 7: wolfxx61 (small blind) folded before Flop
Seat 8: Taargeett (big blind) folded on the Flop
Seat 9: turtlemania1B folded on the River



PokerStars Hand #201224826217: Tournament #2620370251, 8700+1300 Hold'em No Limit - Level I (10/20) - 2019/06/09 11:08:42 ET
Table '2620370251 1' 9-max Seat #7 is the button
Seat 1: Dallas433 (1500 in chips) 
Seat 2: cant_remembr (1480 in chips) 
Seat 3: DGOKER577 (1610 in chips) 
Seat 4: igorrns (1630 in chips) 
Seat 5: chaggi23 (1470 in chips) 
Seat 6: Albtraum72 (1500 in chips) 
Seat 7: wolfxx61 (1470 in chips) is sitting out
Seat 8: Taargeett (1420 in chips) 
Seat 9: turtlemania1B (1440 in chips) 
Taargeett: posts small blind 10
turtlemania1B: posts big blind 20
*** HOLE CARDS ***
Dealt to Taargeett [Qh 6c]
Dallas433: folds 
cant_remembr: calls 20
DGOKER577: calls 20
igorrns: folds 
chaggi23: calls 20
Albtraum72: calls 20
wolfxx61: folds 
Taargeett: folds 
turtlemania1B: raises 1420 to 1440 and is all-in
cant_remembr: folds 
DGOKER577: folds 
chaggi23: calls 1420
Albtraum72: raises 60 to 1500 and is all-in
chaggi23: calls 30 and is all-in
Uncalled bet (30) returned to Albtraum72
*** FLOP *** [2s 8s Qc]
*** TURN *** [2s 8s Qc] [7c]
*** RIVER *** [2s 8s Qc 7c] [3h]
*** SHOW DOWN ***
chaggi23: shows [Kh Qd] (a pair of Queens)
Albtraum72: shows [Jh Kd] (high card King)
chaggi23 collected 60 from side pot
turtlemania1B: shows [Ac 4s] (high card Ace)
chaggi23 collected 4370 from main pot
turtlemania1B finished the tournament
*** SUMMARY ***
Total pot 4430 Main pot 4370. Side pot 60. | Rake 0 
Board [2s 8s Qc 7c 3h]
Seat 1: Dallas433 folded before Flop (didn't bet)
Seat 2: cant_remembr folded before Flop
Seat 3: DGOKER577 folded before Flop
Seat 4: igorrns folded before Flop (didn't bet)
Seat 5: chaggi23 showed [Kh Qd] and won (4430) with a pair of Queens
Seat 6: Albtraum72 showed [Jh Kd] and lost with high card King
Seat 7: wolfxx61 (button) folded before Flop (didn't bet)
Seat 8: Taargeett (small blind) folded before Flop
Seat 9: turtlemania1B (big blind) showed [Ac 4s] and lost with high card Ace



PokerStars Hand #201224858159: Tournament #2620370251, 8700+1300 Hold'em No Limit - Level I (10/20) - 2019/06/09 11:09:43 ET
Table '2620370251 1' 9-max Seat #8 is the button
Seat 1: Dallas433 (1500 in chips) 
Seat 2: cant_remembr (1460 in chips) 
Seat 3: DGOKER577 (1590 in chips) 
Seat 4: igorrns (1630 in chips) 
Seat 5: chaggi23 (4430 in chips) 
Seat 6: Albtraum72 (30 in chips) 
Seat 7: wolfxx61 (1470 in chips) is sitting out
Seat 8: Taargeett (1410 in chips) 
Seat 9: Taiasa (1500 in chips) out of hand (moved from another table into small blind)
Taiasa will be allowed to play after the button
Dallas433: posts small blind 10
cant_remembr: posts big blind 20
*** HOLE CARDS ***
Dealt to Taargeett [Kc 8s]
DGOKER577: folds 
igorrns: calls 20
chaggi23: folds 
Albtraum72: raises 10 to 30 and is all-in
wolfxx61: folds 
Taargeett: calls 30
Dallas433: calls 20
cant_remembr: calls 10
igorrns: calls 10
*** FLOP *** [2h 5s 3c]
Dallas433: checks 
cant_remembr: checks 
igorrns: bets 150
Taargeett: folds 
Dallas433: folds 
cant_remembr: calls 150
*** TURN *** [2h 5s 3c] [Ah]
cant_remembr: checks 
igorrns: bets 225
cant_remembr: raises 900 to 1125
igorrns: raises 325 to 1450 and is all-in
cant_remembr: calls 155 and is all-in
Uncalled bet (170) returned to igorrns
*** RIVER *** [2h 5s 3c Ah] [3d]
*** SHOW DOWN ***
cant_remembr: shows [Th 4h] (a straight, Ace to Five)
igorrns: shows [As 2s] (two pair, Aces and Threes)
cant_remembr collected 2860 from side pot
Albtraum72: shows [Jd Qc] (a pair of Threes)
cant_remembr collected 150 from main pot
Albtraum72 finished the tournament
*** SUMMARY ***
Total pot 3010 Main pot 150. Side pot 2860. | Rake 0 
Board [2h 5s 3c Ah 3d]
Seat 1: Dallas433 (small blind) folded on the Flop
Seat 2: cant_remembr (big blind) showed [Th 4h] and won (3010) with a straight, Ace to Five
Seat 3: DGOKER577 folded before Flop (didn't bet)
Seat 4: igorrns showed [As 2s] and lost with two pair, Aces and Threes
Seat 5: chaggi23 folded before Flop (didn't bet)
Seat 6: Albtraum72 showed [Jd Qc] and lost with a pair of Threes
Seat 7: wolfxx61 folded before Flop (didn't bet)
Seat 8: Taargeett (button) folded on the Flop



PokerStars Hand #201224890469: Tournament #2620370251, 8700+1300 Hold'em No Limit - Level II (15/30) - 2019/06/09 11:10:44 ET
Table '2620370251 1' 9-max Seat #1 is the button
Seat 1: Dallas433 (1470 in chips) 
Seat 2: cant_remembr (3010 in chips) 
Seat 3: DGOKER577 (1590 in chips) 
Seat 4: igorrns (170 in chips) 
Seat 5: chaggi23 (4430 in chips) 
Seat 7: wolfxx61 (1470 in chips) is sitting out
Seat 8: Taargeett (1380 in chips) 
Seat 9: Taiasa (1500 in chips) 
cant_remembr: posts small blind 15
DGOKER577: posts big blind 30
*** HOLE CARDS ***
Dealt to Taargeett [Kh 5c]
igorrns: raises 140 to 170 and is all-in
chaggi23: folds 
wolfxx61: folds 
Taargeett: folds 
Taiasa: calls 170
Dallas433: folds 
cant_remembr: folds 
DGOKER577: calls 140
*** FLOP *** [2s Ad 9c]
DGOKER577: checks 
Taiasa: checks 
*** TURN *** [2s Ad 9c] [Jd]
DGOKER577: bets 30
Taiasa: calls 30
*** RIVER *** [2s Ad 9c Jd] [5d]
DGOKER577: bets 30
Taiasa: calls 30
*** SHOW DOWN ***
DGOKER577: shows [Ks 8h] (high card Ace)
Taiasa: shows [2h Qh] (a pair of Deuces)
Taiasa collected 120 from side pot
igorrns: shows [7c 7h] (a pair of Sevens)
igorrns collected 525 from main pot
*** SUMMARY ***
Total pot 645 Main pot 525. Side pot 120. | Rake 0 
Board [2s Ad 9c Jd 5d]
Seat 1: Dallas433 (button) folded before Flop (didn't bet)
Seat 2: cant_remembr (small blind) folded before Flop
Seat 3: DGOKER577 (big blind) showed [Ks 8h] and lost with high card Ace
Seat 4: igorrns showed [7c 7h] and won (525) with a pair of Sevens
Seat 5: chaggi23 folded before Flop (didn't bet)
Seat 7: wolfxx61 folded before Flop (didn't bet)
Seat 8: Taargeett folded before Flop (didn't bet)
Seat 9: Taiasa showed [2h Qh] and won (120) with a pair of Deuces



PokerStars Hand #201224920092: Tournament #2620370251, 8700+1300 Hold'em No Limit - Level II (15/30) - 2019/06/09 11:11:40 ET
Table '2620370251 1' 9-max Seat #2 is the button
Seat 1: Dallas433 (1470 in chips) 
Seat 2: cant_remembr (2995 in chips) 
Seat 3: DGOKER577 (1360 in chips) 
Seat 4: igorrns (525 in chips) 
Seat 5: chaggi23 (4430 in chips) 
Seat 6: dzwoniec (1500 in chips) 
Seat 7: wolfxx61 (1470 in chips) is sitting out
Seat 8: Taargeett (1380 in chips) 
Seat 9: Taiasa (1390 in chips) 
DGOKER577: posts small blind 15
igorrns: posts big blind 30
*** HOLE CARDS ***
Dealt to Taargeett [As 6h]
chaggi23: folds 
dzwoniec: calls 30
wolfxx61: folds 
Taargeett: raises 60 to 90
Taiasa: calls 90
Dallas433: folds 
cant_remembr: folds 
DGOKER577: calls 75
igorrns: folds 
dzwoniec: calls 60
*** FLOP *** [Ac 2c Kc]
DGOKER577: bets 1270 and is all-in
dzwoniec: folds 
Taargeett: folds 
Taiasa: calls 1270
*** TURN *** [Ac 2c Kc] [5s]
*** RIVER *** [Ac 2c Kc 5s] [9c]
*** SHOW DOWN ***
DGOKER577: shows [Ah 7d] (a pair of Aces)
Taiasa: shows [Qh Th] (high card Ace)
DGOKER577 collected 2930 from pot
*** SUMMARY ***
Total pot 2930 | Rake 0 
Board [Ac 2c Kc 5s 9c]
Seat 1: Dallas433 folded before Flop (didn't bet)
Seat 2: cant_remembr (button) folded before Flop (didn't bet)
Seat 3: DGOKER577 (small blind) showed [Ah 7d] and won (2930) with a pair of Aces
Seat 4: igorrns (big blind) folded before Flop
Seat 5: chaggi23 folded before Flop (didn't bet)
Seat 6: dzwoniec folded on the Flop
Seat 7: wolfxx61 folded before Flop (didn't bet)
Seat 8: Taargeett folded on the Flop
Seat 9: Taiasa showed [Qh Th] and lost with high card Ace



PokerStars Hand #201224958565: Tournament #2620370251, 8700+1300 Hold'em No Limit - Level II (15/30) - 2019/06/09 11:12:53 ET
Table '2620370251 1' 9-max Seat #3 is the button
Seat 1: Dallas433 (1470 in chips) 
Seat 2: cant_remembr (2995 in chips) 
Seat 3: DGOKER577 (2930 in chips) 
Seat 4: igorrns (495 in chips) 
Seat 5: chaggi23 (4430 in chips) 
Seat 6: dzwoniec (1410 in chips) 
Seat 7: wolfxx61 (1470 in chips) is sitting out
Seat 8: Taargeett (1290 in chips) 
Seat 9: Taiasa (30 in chips) 
igorrns: posts small blind 15
chaggi23: posts big blind 30
*** HOLE CARDS ***
Dealt to Taargeett [8s 6h]
dzwoniec: calls 30
wolfxx61: folds 
Taargeett: folds 
Taiasa: calls 30 and is all-in
Dallas433: folds 
cant_remembr: folds 
DGOKER577: calls 30
igorrns: folds 
chaggi23: checks 
*** FLOP *** [Jd Ah Kd]
chaggi23: checks 
dzwoniec: checks 
DGOKER577: checks 
*** TURN *** [Jd Ah Kd] [7c]
chaggi23: checks 
dzwoniec: checks 
DGOKER577: checks 
*** RIVER *** [Jd Ah Kd 7c] [Td]
chaggi23: bets 360
dzwoniec: folds 
DGOKER577: folds 
Uncalled bet (360) returned to chaggi23
*** SHOW DOWN ***
chaggi23: shows [As 8d] (a pair of Aces)
Taiasa: shows [7h Qc] (a straight, Ten to Ace)
Taiasa collected 135 from pot
*** SUMMARY ***
Total pot 135 | Rake 0 
Board [Jd Ah Kd 7c Td]
Seat 1: Dallas433 folded before Flop (didn't bet)
Seat 2: cant_remembr folded before Flop (didn't bet)
Seat 3: DGOKER577 (button) folded on the River
Seat 4: igorrns (small blind) folded before Flop
Seat 5: chaggi23 (big blind) showed [As 8d] and lost with a pair of Aces
Seat 6: dzwoniec folded on the River
Seat 7: wolfxx61 folded before Flop (didn't bet)
Seat 8: Taargeett folded before Flop (didn't bet)
Seat 9: Taiasa showed [7h Qc] and won (135) with a straight, Ten to Ace



PokerStars Hand #201224989240: Tournament #2620370251, 8700+1300 Hold'em No Limit - Level II (15/30) - 2019/06/09 11:13:50 ET
Table '2620370251 1' 9-max Seat #4 is the button
Seat 1: Dallas433 (1470 in chips) 
Seat 2: cant_remembr (2995 in chips) 
Seat 3: DGOKER577 (2900 in chips) 
Seat 4: igorrns (480 in chips) 
Seat 5: chaggi23 (4400 in chips) 
Seat 6: dzwoniec (1380 in chips) 
Seat 7: wolfxx61 (1470 in chips) is sitting out
Seat 8: Taargeett (1290 in chips) 
Seat 9: Taiasa (135 in chips) 
chaggi23: posts small blind 15
dzwoniec: posts big blind 30
*** HOLE CARDS ***
Dealt to Taargeett [Ks Ah]
wolfxx61: folds 
Taargeett: raises 60 to 90
Taiasa: raises 45 to 135 and is all-in
Dallas433: folds 
cant_remembr: calls 135
DGOKER577: folds 
igorrns: folds 
chaggi23: folds 
dzwoniec: calls 105
Taargeett: calls 45
*** FLOP *** [Jd 5h Ts]
dzwoniec: checks 
Taargeett: bets 240
cant_remembr: calls 240
dzwoniec: folds 
*** TURN *** [Jd 5h Ts] [9s]
Taargeett: bets 915 and is all-in
cant_remembr: calls 915
*** RIVER *** [Jd 5h Ts 9s] [Kc]
*** SHOW DOWN ***
Taargeett: shows [Ks Ah] (a pair of Kings)
cant_remembr: shows [Th Ac] (a pair of Tens)
Taargeett collected 2310 from side pot
Taiasa: shows [7h Jh] (a pair of Jacks)
Taargeett collected 555 from main pot
Taiasa finished the tournament
*** SUMMARY ***
Total pot 2865 Main pot 555. Side pot 2310. | Rake 0 
Board [Jd 5h Ts 9s Kc]
Seat 1: Dallas433 folded before Flop (didn't bet)
Seat 2: cant_remembr showed [Th Ac] and lost with a pair of Tens
Seat 3: DGOKER577 folded before Flop (didn't bet)
Seat 4: igorrns (button) folded before Flop (didn't bet)
Seat 5: chaggi23 (small blind) folded before Flop
Seat 6: dzwoniec (big blind) folded on the Flop
Seat 7: wolfxx61 folded before Flop (didn't bet)
Seat 8: Taargeett showed [Ks Ah] and won (2865) with a pair of Kings
Seat 9: Taiasa showed [7h Jh] and lost with a pair of Jacks



PokerStars Hand #201225029757: Tournament #2620370251, 8700+1300 Hold'em No Limit - Level III (25/50) - 2019/06/09 11:15:06 ET
Table '2620370251 1' 9-max Seat #5 is the button
Seat 1: Dallas433 (1470 in chips) 
Seat 2: cant_remembr (1705 in chips) 
Seat 3: DGOKER577 (2900 in chips) 
Seat 4: igorrns (480 in chips) 
Seat 5: chaggi23 (4385 in chips) 
Seat 6: dzwoniec (1245 in chips) 
Seat 7: wolfxx61 (1470 in chips) is sitting out
Seat 8: Taargeett (2865 in chips) 
dzwoniec: posts small blind 25
wolfxx61: posts big blind 50
*** HOLE CARDS ***
Dealt to Taargeett [2d 7d]
Taargeett: folds 
Dallas433: raises 1420 to 1470 and is all-in
cant_remembr: folds 
DGOKER577: folds 
igorrns: folds 
chaggi23: folds 
dzwoniec: calls 1220 and is all-in
wolfxx61: folds 
Uncalled bet (225) returned to Dallas433
*** FLOP *** [4c Ac 8h]
*** TURN *** [4c Ac 8h] [3c]
*** RIVER *** [4c Ac 8h 3c] [Qs]
*** SHOW DOWN ***
dzwoniec: shows [5h 5s] (a pair of Fives)
Dallas433: shows [Kc Qc] (a flush, Ace high)
Dallas433 collected 2540 from pot
dzwoniec finished the tournament
*** SUMMARY ***
Total pot 2540 | Rake 0 
Board [4c Ac 8h 3c Qs]
Seat 1: Dallas433 showed [Kc Qc] and won (2540) with a flush, Ace high
Seat 2: cant_remembr folded before Flop (didn't bet)
Seat 3: DGOKER577 folded before Flop (didn't bet)
Seat 4: igorrns folded before Flop (didn't bet)
Seat 5: chaggi23 (button) folded before Flop (didn't bet)
Seat 6: dzwoniec (small blind) showed [5h 5s] and lost with a pair of Fives
Seat 7: wolfxx61 (big blind) folded before Flop
Seat 8: Taargeett folded before Flop (didn't bet)



PokerStars Hand #201225054026: Tournament #2620370251, 8700+1300 Hold'em No Limit - Level III (25/50) - 2019/06/09 11:15:52 ET
Table '2620370251 1' 9-max Seat #7 is the button
Seat 1: Dallas433 (2765 in chips) 
Seat 2: cant_remembr (1705 in chips) 
Seat 3: DGOKER577 (2900 in chips) 
Seat 4: igorrns (480 in chips) 
Seat 5: chaggi23 (4385 in chips) 
Seat 6: ahmrya83 (1500 in chips) 
Seat 7: wolfxx61 (1420 in chips) is sitting out
Seat 8: Taargeett (2865 in chips) 
Seat 9: knkn1717 (1500 in chips) 
Taargeett: posts small blind 25
knkn1717: posts big blind 50
*** HOLE CARDS ***
Dealt to Taargeett [2d 2c]
Dallas433: calls 50
cant_remembr: folds 
DGOKER577: folds 
igorrns: folds 
chaggi23: raises 50 to 100
ahmrya83 is connected 
ahmrya83: folds 
wolfxx61: folds 
Taargeett: folds 
knkn1717: calls 50
Dallas433: calls 50
*** FLOP *** [Tc Kd Ts]
knkn1717: bets 1400 and is all-in
Dallas433: raises 1265 to 2665 and is all-in
chaggi23: folds 
Uncalled bet (1265) returned to Dallas433
*** TURN *** [Tc Kd Ts] [9h]
*** RIVER *** [Tc Kd Ts 9h] [Ac]
*** SHOW DOWN ***
knkn1717: shows [8s 4s] (a pair of Tens)
Dallas433: shows [As Th] (a full house, Tens full of Aces)
Dallas433 collected 3125 from pot
knkn1717 finished the tournament
*** SUMMARY ***
Total pot 3125 | Rake 0 
Board [Tc Kd Ts 9h Ac]
Seat 1: Dallas433 showed [As Th] and won (3125) with a full house, Tens full of Aces
Seat 2: cant_remembr folded before Flop (didn't bet)
Seat 3: DGOKER577 folded before Flop (didn't bet)
Seat 4: igorrns folded before Flop (didn't bet)
Seat 5: chaggi23 folded on the Flop
Seat 6: ahmrya83 folded before Flop (didn't bet)
Seat 7: wolfxx61 (button) folded before Flop (didn't bet)
Seat 8: Taargeett (small blind) folded before Flop
Seat 9: knkn1717 (big blind) showed [8s 4s] and lost with a pair of Tens



PokerStars Hand #201225076003: Tournament #2620370251, 8700+1300 Hold'em No Limit - Level III (25/50) - 2019/06/09 11:16:33 ET
Table '2620370251 1' 9-max Seat #8 is the button
Seat 1: Dallas433 (4390 in chips) 
Seat 2: cant_remembr (1705 in chips) 
Seat 3: DGOKER577 (2900 in chips) 
Seat 4: igorrns (480 in chips) 
Seat 5: chaggi23 (4285 in chips) 
Seat 6: ahmrya83 (1500 in chips) 
Seat 7: wolfxx61 (1420 in chips) is sitting out
Seat 8: Taargeett (2840 in chips) 
Dallas433: posts small blind 25
cant_remembr: posts big blind 50
*** HOLE CARDS ***
Dealt to Taargeett [5h 9h]
DGOKER577: calls 50
igorrns: folds 
chaggi23: folds 
ahmrya83: calls 50
wolfxx61: folds 
Taargeett: raises 100 to 150
Dallas433: folds 
cant_remembr: folds 
DGOKER577: calls 100
ahmrya83: calls 100
*** FLOP *** [As 5s Td]
DGOKER577: checks 
ahmrya83: checks 
Taargeett: bets 200
DGOKER577: calls 200
ahmrya83: folds 
*** TURN *** [As 5s Td] [2h]
DGOKER577: checks 
Taargeett: bets 400
DGOKER577: folds 
Uncalled bet (400) returned to Taargeett
Taargeett collected 925 from pot
Taargeett: doesn't show hand 
*** SUMMARY ***
Total pot 925 | Rake 0 
Board [As 5s Td 2h]
Seat 1: Dallas433 (small blind) folded before Flop
Seat 2: cant_remembr (big blind) folded before Flop
Seat 3: DGOKER577 folded on the Turn
Seat 4: igorrns folded before Flop (didn't bet)
Seat 5: chaggi23 folded before Flop (didn't bet)
Seat 6: ahmrya83 folded on the Flop
Seat 7: wolfxx61 folded before Flop (didn't bet)
Seat 8: Taargeett (button) collected (925)



PokerStars Hand #201225109582: Tournament #2620370251, 8700+1300 Hold'em No Limit - Level III (25/50) - 2019/06/09 11:17:36 ET
Table '2620370251 1' 9-max Seat #1 is the button
Seat 1: Dallas433 (4365 in chips) 
Seat 2: cant_remembr (1655 in chips) 
Seat 3: DGOKER577 (2550 in chips) 
Seat 4: igorrns (480 in chips) 
Seat 5: chaggi23 (4285 in chips) 
Seat 6: ahmrya83 (1350 in chips) 
Seat 7: wolfxx61 (1420 in chips) is sitting out
Seat 8: Taargeett (3415 in chips) 
Seat 9: gokou56100 (1500 in chips) 
cant_remembr: posts small blind 25
DGOKER577: posts big blind 50
*** HOLE CARDS ***
Dealt to Taargeett [Ad Jd]
igorrns: folds 
chaggi23: folds 
ahmrya83: calls 50
wolfxx61: folds 
Taargeett: raises 100 to 150
gokou56100: raises 425 to 575
Dallas433: folds 
cant_remembr: folds 
DGOKER577: folds 
ahmrya83: folds 
Taargeett: raises 425 to 1000
gokou56100: calls 425
*** FLOP *** [9s Ts 4d]
Taargeett: checks 
gokou56100: checks 
*** TURN *** [9s Ts 4d] [3d]
Taargeett: bets 2415 and is all-in
gokou56100: calls 500 and is all-in
Uncalled bet (1915) returned to Taargeett
*** RIVER *** [9s Ts 4d 3d] [5s]
*** SHOW DOWN ***
Taargeett: shows [Ad Jd] (high card Ace)
gokou56100: shows [As Qs] (a flush, Ace high)
gokou56100 collected 3125 from pot
*** SUMMARY ***
Total pot 3125 | Rake 0 
Board [9s Ts 4d 3d 5s]
Seat 1: Dallas433 (button) folded before Flop (didn't bet)
Seat 2: cant_remembr (small blind) folded before Flop
Seat 3: DGOKER577 (big blind) folded before Flop
Seat 4: igorrns folded before Flop (didn't bet)
Seat 5: chaggi23 folded before Flop (didn't bet)
Seat 6: ahmrya83 folded before Flop
Seat 7: wolfxx61 folded before Flop (didn't bet)
Seat 8: Taargeett showed [Ad Jd] and lost with high card Ace
Seat 9: gokou56100 showed [As Qs] and won (3125) with a flush, Ace high



PokerStars Hand #201225137485: Tournament #2620370251, 8700+1300 Hold'em No Limit - Level III (25/50) - 2019/06/09 11:18:28 ET
Table '2620370251 1' 9-max Seat #2 is the button
Seat 1: Dallas433 (4365 in chips) 
Seat 2: cant_remembr (1630 in chips) 
Seat 3: DGOKER577 (2500 in chips) 
Seat 4: igorrns (480 in chips) 
Seat 5: chaggi23 (4285 in chips) 
Seat 6: ahmrya83 (1300 in chips) 
Seat 7: wolfxx61 (1420 in chips) is sitting out
Seat 8: Taargeett (1915 in chips) 
Seat 9: gokou56100 (3125 in chips) 
DGOKER577: posts small blind 25
igorrns: posts big blind 50
*** HOLE CARDS ***
Dealt to Taargeett [3s 4h]
chaggi23: folds 
ahmrya83: calls 50
wolfxx61: folds 
Taargeett: folds 
gokou56100: raises 50 to 100
Dallas433: calls 100
cant_remembr: calls 100
DGOKER577: calls 75
igorrns: raises 380 to 480 and is all-in
ahmrya83: folds 
gokou56100: calls 380
Dallas433: calls 380
cant_remembr: calls 380
DGOKER577: calls 380
*** FLOP *** [Jd Js Qh]
DGOKER577: checks 
gokou56100: checks 
Dallas433: checks 
cant_remembr: checks 
*** TURN *** [Jd Js Qh] [Ah]
DGOKER577: checks 
gokou56100: bets 50
Dallas433: folds 
cant_remembr: raises 1100 to 1150 and is all-in
DGOKER577: folds 
gokou56100: calls 1100
*** RIVER *** [Jd Js Qh Ah] [9s]
*** SHOW DOWN ***
gokou56100: shows [9h Ac] (two pair, Aces and Jacks)
cant_remembr: shows [Kh As] (two pair, Aces and Jacks - King kicker)
cant_remembr collected 2300 from side pot
igorrns: shows [Ts Td] (two pair, Jacks and Tens)
cant_remembr collected 2450 from main pot
igorrns finished the tournament
*** SUMMARY ***
Total pot 4750 Main pot 2450. Side pot 2300. | Rake 0 
Board [Jd Js Qh Ah 9s]
Seat 1: Dallas433 folded on the Turn
Seat 2: cant_remembr (button) showed [Kh As] and won (4750) with two pair, Aces and Jacks
Seat 3: DGOKER577 (small blind) folded on the Turn
Seat 4: igorrns (big blind) showed [Ts Td] and lost with two pair, Jacks and Tens
Seat 5: chaggi23 folded before Flop (didn't bet)
Seat 6: ahmrya83 folded before Flop
Seat 7: wolfxx61 folded before Flop (didn't bet)
Seat 8: Taargeett folded before Flop (didn't bet)
Seat 9: gokou56100 showed [9h Ac] and lost with two pair, Aces and Jacks



PokerStars Hand #201225175232: Tournament #2620370251, 8700+1300 Hold'em No Limit - Level III (25/50) - 2019/06/09 11:19:35 ET
Table '2620370251 1' 9-max Seat #3 is the button
Seat 1: Dallas433 (3885 in chips) 
Seat 2: cant_remembr (4750 in chips) 
Seat 3: DGOKER577 (2020 in chips) 
Seat 5: chaggi23 (4285 in chips) 
Seat 6: ahmrya83 (1250 in chips) 
Seat 7: wolfxx61 (1420 in chips) is sitting out
Seat 8: Taargeett (1915 in chips) 
Seat 9: gokou56100 (1495 in chips) 
chaggi23: posts small blind 25
ahmrya83: posts big blind 50
*** HOLE CARDS ***
Dealt to Taargeett [Ac 9h]
wolfxx61: folds 
Taargeett: folds 
gokou56100 has timed out
gokou56100: folds 
Dallas433: folds 
cant_remembr: folds 
DGOKER577: calls 50
chaggi23: folds 
ahmrya83: checks 
*** FLOP *** [4h 8d As]
ahmrya83: checks 
DGOKER577: bets 50
ahmrya83: folds 
Uncalled bet (50) returned to DGOKER577
DGOKER577 collected 125 from pot
*** SUMMARY ***
Total pot 125 | Rake 0 
Board [4h 8d As]
Seat 1: Dallas433 folded before Flop (didn't bet)
Seat 2: cant_remembr folded before Flop (didn't bet)
Seat 3: DGOKER577 (button) collected (125)
Seat 5: chaggi23 (small blind) folded before Flop
Seat 6: ahmrya83 (big blind) folded on the Flop
Seat 7: wolfxx61 folded before Flop (didn't bet)
Seat 8: Taargeett folded before Flop (didn't bet)
Seat 9: gokou56100 folded before Flop (didn't bet)



PokerStars Hand #201225200505: Tournament #2620370251, 8700+1300 Hold'em No Limit - Level IV (50/100) - 2019/06/09 11:20:22 ET
Table '2620370251 1' 9-max Seat #5 is the button
Seat 1: Dallas433 (3885 in chips) 
Seat 2: cant_remembr (4750 in chips) 
Seat 3: DGOKER577 (2095 in chips) 
Seat 5: chaggi23 (4260 in chips) 
Seat 6: ahmrya83 (1200 in chips) 
Seat 7: wolfxx61 (1420 in chips) is sitting out
Seat 8: Taargeett (1915 in chips) 
Seat 9: gokou56100 (1495 in chips) 
ahmrya83: posts small blind 50
wolfxx61: posts big blind 100
*** HOLE CARDS ***
Dealt to Taargeett [Qh 3c]
Taargeett: folds 
gokou56100: calls 100
Dallas433: calls 100
cant_remembr: folds 
DGOKER577: calls 100
chaggi23: folds 
ahmrya83: calls 50
wolfxx61: folds 
*** FLOP *** [Ah Td 6c]
ahmrya83: checks 
gokou56100: checks 
Dallas433: checks 
DGOKER577: checks 
*** TURN *** [Ah Td 6c] [Jc]
ahmrya83: bets 200
gokou56100: folds 
Dallas433: calls 200
DGOKER577: folds 
*** RIVER *** [Ah Td 6c Jc] [5c]
ahmrya83: bets 900 and is all-in
Dallas433: calls 900
*** SHOW DOWN ***
ahmrya83: shows [6d 9c] (a pair of Sixes)
Dallas433: shows [Ad 7d] (a pair of Aces)
Dallas433 collected 2700 from pot
ahmrya83 finished the tournament
*** SUMMARY ***
Total pot 2700 | Rake 0 
Board [Ah Td 6c Jc 5c]
Seat 1: Dallas433 showed [Ad 7d] and won (2700) with a pair of Aces
Seat 2: cant_remembr folded before Flop (didn't bet)
Seat 3: DGOKER577 folded on the Turn
Seat 5: chaggi23 (button) folded before Flop (didn't bet)
Seat 6: ahmrya83 (small blind) showed [6d 9c] and lost with a pair of Sixes
Seat 7: wolfxx61 (big blind) folded before Flop
Seat 8: Taargeett folded before Flop (didn't bet)
Seat 9: gokou56100 folded on the Turn



PokerStars Hand #201225233999: Tournament #2620370251, 8700+1300 Hold'em No Limit - Level IV (50/100) - 2019/06/09 11:21:25 ET
Table '2620370251 1' 9-max Seat #7 is the button
Seat 1: Dallas433 (5385 in chips) 
Seat 2: cant_remembr (4750 in chips) 
Seat 3: DGOKER577 (1995 in chips) 
Seat 4: butch1409 (1500 in chips) 
Seat 5: chaggi23 (4260 in chips) 
Seat 7: wolfxx61 (1320 in chips) is sitting out
Seat 8: Taargeett (1915 in chips) 
Seat 9: gokou56100 (1395 in chips) 
Taargeett: posts small blind 50
gokou56100: posts big blind 100
*** HOLE CARDS ***
Dealt to Taargeett [Jc Jh]
Dallas433: folds 
cant_remembr: folds 
DGOKER577: folds 
butch1409: calls 100
chaggi23: folds 
wolfxx61: folds 
Taargeett: raises 100 to 200
gokou56100: calls 100
butch1409: raises 100 to 300
Taargeett: raises 400 to 700
gokou56100: folds 
butch1409: calls 400
*** FLOP *** [Ah 2h 9c]
Taargeett: checks 
butch1409: bets 800 and is all-in
Taargeett: calls 800
*** TURN *** [Ah 2h 9c] [8h]
*** RIVER *** [Ah 2h 9c 8h] [3h]
*** SHOW DOWN ***
Taargeett: shows [Jc Jh] (a flush, Ace high)
butch1409: shows [7h Ac] (a flush, Ace high - lower cards)
Taargeett collected 3200 from pot
butch1409 finished the tournament
*** SUMMARY ***
Total pot 3200 | Rake 0 
Board [Ah 2h 9c 8h 3h]
Seat 1: Dallas433 folded before Flop (didn't bet)
Seat 2: cant_remembr folded before Flop (didn't bet)
Seat 3: DGOKER577 folded before Flop (didn't bet)
Seat 4: butch1409 showed [7h Ac] and lost with a flush, Ace high
Seat 5: chaggi23 folded before Flop (didn't bet)
Seat 7: wolfxx61 (button) folded before Flop (didn't bet)
Seat 8: Taargeett (small blind) showed [Jc Jh] and won (3200) with a flush, Ace high
Seat 9: gokou56100 (big blind) folded before Flop



PokerStars Hand #201225257493: Tournament #2620370251, 8700+1300 Hold'em No Limit - Level IV (50/100) - 2019/06/09 11:22:09 ET
Table '2620370251 1' 9-max Seat #8 is the button
Seat 1: Dallas433 (5385 in chips) 
Seat 2: cant_remembr (4750 in chips) 
Seat 3: DGOKER577 (1995 in chips) 
Seat 4: Lee-Roy78LS (1500 in chips) 
Seat 5: chaggi23 (4260 in chips) 
Seat 6: karim199773 (1500 in chips) 
Seat 7: wolfxx61 (1320 in chips) is sitting out
Seat 8: Taargeett (3615 in chips) 
Seat 9: gokou56100 (1195 in chips) 
gokou56100: posts small blind 50
Dallas433: posts big blind 100
*** HOLE CARDS ***
Dealt to Taargeett [Ks 7c]
cant_remembr: calls 100
DGOKER577: raises 1895 to 1995 and is all-in
Lee-Roy78LS: calls 1500 and is all-in
chaggi23: folds 
karim199773: folds 
wolfxx61: folds 
Taargeett: folds 
gokou56100: calls 1145 and is all-in
Dallas433: folds 
cant_remembr: folds 
Uncalled bet (495) returned to DGOKER577
*** FLOP *** [Qh 2s 6d]
*** TURN *** [Qh 2s 6d] [Qc]
*** RIVER *** [Qh 2s 6d Qc] [Js]
*** SHOW DOWN ***
DGOKER577: shows [8s 8c] (two pair, Queens and Eights)
Lee-Roy78LS: shows [Jd Ah] (two pair, Queens and Jacks)
Lee-Roy78LS collected 610 from side pot
gokou56100: shows [Qd 3h] (three of a kind, Queens)
gokou56100 collected 3785 from main pot
*** SUMMARY ***
Total pot 4395 Main pot 3785. Side pot 610. | Rake 0 
Board [Qh 2s 6d Qc Js]
Seat 1: Dallas433 (big blind) folded before Flop
Seat 2: cant_remembr folded before Flop
Seat 3: DGOKER577 showed [8s 8c] and lost with two pair, Queens and Eights
Seat 4: Lee-Roy78LS showed [Jd Ah] and won (610) with two pair, Queens and Jacks
Seat 5: chaggi23 folded before Flop (didn't bet)
Seat 6: karim199773 folded before Flop (didn't bet)
Seat 7: wolfxx61 folded before Flop (didn't bet)
Seat 8: Taargeett (button) folded before Flop (didn't bet)
Seat 9: gokou56100 (small blind) showed [Qd 3h] and won (3785) with three of a kind, Queens



PokerStars Hand #201225274549: Tournament #2620370251, 8700+1300 Hold'em No Limit - Level IV (50/100) - 2019/06/09 11:22:41 ET
Table '2620370251 1' 9-max Seat #9 is the button
Seat 1: Dallas433 (5285 in chips) 
Seat 2: cant_remembr (4650 in chips) 
Seat 3: DGOKER577 (495 in chips) 
Seat 4: Lee-Roy78LS (610 in chips) 
Seat 5: chaggi23 (4260 in chips) 
Seat 6: karim199773 (1500 in chips) 
Seat 7: wolfxx61 (1320 in chips) is sitting out
Seat 8: Taargeett (3615 in chips) 
Seat 9: gokou56100 (3785 in chips) 
Dallas433: posts small blind 50
cant_remembr: posts big blind 100
*** HOLE CARDS ***
Dealt to Taargeett [5s Jc]
DGOKER577: raises 395 to 495 and is all-in
Lee-Roy78LS: raises 115 to 610 and is all-in
chaggi23: folds 
karim199773: calls 610
wolfxx61: folds 
Taargeett: folds 
gokou56100: calls 610
Dallas433: folds 
cant_remembr: folds 
*** FLOP *** [9d Ks Ac]
karim199773: bets 890 and is all-in
gokou56100: calls 890
*** TURN *** [9d Ks Ac] [9s]
*** RIVER *** [9d Ks Ac 9s] [Td]
*** SHOW DOWN ***
karim199773: shows [9c Jd] (three of a kind, Nines)
gokou56100: shows [6s Qc] (a pair of Nines)
karim199773 collected 1780 from side pot-2 
Lee-Roy78LS: shows [Jh Qh] (a straight, Ten to Ace)
Lee-Roy78LS collected 345 from side pot-1 
DGOKER577: shows [Th 8d] (two pair, Tens and Nines)
Lee-Roy78LS collected 2130 from main pot
DGOKER577 finished the tournament
*** SUMMARY ***
Total pot 4255 Main pot 2130. Side pot-1 345. Side pot-2 1780. | Rake 0 
Board [9d Ks Ac 9s Td]
Seat 1: Dallas433 (small blind) folded before Flop
Seat 2: cant_remembr (big blind) folded before Flop
Seat 3: DGOKER577 showed [Th 8d] and lost with two pair, Tens and Nines
Seat 4: Lee-Roy78LS showed [Jh Qh] and won (2475) with a straight, Ten to Ace
Seat 5: chaggi23 folded before Flop (didn't bet)
Seat 6: karim199773 showed [9c Jd] and won (1780) with three of a kind, Nines
Seat 7: wolfxx61 folded before Flop (didn't bet)
Seat 8: Taargeett folded before Flop (didn't bet)
Seat 9: gokou56100 (button) showed [6s Qc] and lost with a pair of Nines



PokerStars Hand #201225291368: Tournament #2620370251, 8700+1300 Hold'em No Limit - Level IV (50/100) - 2019/06/09 11:23:12 ET
Table '2620370251 1' 9-max Seat #1 is the button
Seat 1: Dallas433 (5235 in chips) 
Seat 2: cant_remembr (4550 in chips) 
Seat 4: Lee-Roy78LS (2475 in chips) 
Seat 5: chaggi23 (4260 in chips) 
Seat 6: karim199773 (1780 in chips) 
Seat 7: wolfxx61 (1320 in chips) is sitting out
Seat 8: Taargeett (3615 in chips) 
Seat 9: gokou56100 (2285 in chips) 
cant_remembr: posts small blind 50
Lee-Roy78LS: posts big blind 100
*** HOLE CARDS ***
Dealt to Taargeett [5s Ac]
chaggi23: folds 
karim199773: raises 1680 to 1780 and is all-in
wolfxx61: folds 
Taargeett: folds 
gokou56100: folds 
Dallas433: calls 1780
cant_remembr: folds 
Lee-Roy78LS: folds 
*** FLOP *** [Ts Kc 3h]
*** TURN *** [Ts Kc 3h] [4h]
*** RIVER *** [Ts Kc 3h 4h] [Td]
*** SHOW DOWN ***
karim199773: shows [Qh Ks] (two pair, Kings and Tens)
Dallas433: shows [Ad 9s] (a pair of Tens)
karim199773 collected 3710 from pot
*** SUMMARY ***
Total pot 3710 | Rake 0 
Board [Ts Kc 3h 4h Td]
Seat 1: Dallas433 (button) showed [Ad 9s] and lost with a pair of Tens
Seat 2: cant_remembr (small blind) folded before Flop
Seat 4: Lee-Roy78LS (big blind) folded before Flop
Seat 5: chaggi23 folded before Flop (didn't bet)
Seat 6: karim199773 showed [Qh Ks] and won (3710) with two pair, Kings and Tens
Seat 7: wolfxx61 folded before Flop (didn't bet)
Seat 8: Taargeett folded before Flop (didn't bet)
Seat 9: gokou56100 folded before Flop (didn't bet)



PokerStars Hand #201225307681: Tournament #2620370251, 8700+1300 Hold'em No Limit - Level IV (50/100) - 2019/06/09 11:23:43 ET
Table '2620370251 1' 9-max Seat #2 is the button
Seat 1: Dallas433 (3455 in chips) 
Seat 2: cant_remembr (4500 in chips) 
Seat 3: roy4ou (1500 in chips) out of hand (moved from another table into small blind)
Seat 4: Lee-Roy78LS (2375 in chips) 
Seat 5: chaggi23 (4260 in chips) 
Seat 6: karim199773 (3710 in chips) 
Seat 7: wolfxx61 (1320 in chips) is sitting out
Seat 8: Taargeett (3615 in chips) 
Seat 9: gokou56100 (2285 in chips) 
roy4ou will be allowed to play after the button
Lee-Roy78LS: posts small blind 50
chaggi23: posts big blind 100
*** HOLE CARDS ***
Dealt to Taargeett [Js 5s]
karim199773: folds 
wolfxx61: folds 
Taargeett: raises 100 to 200
gokou56100: raises 2085 to 2285 and is all-in
Dallas433: folds 
cant_remembr: folds 
Lee-Roy78LS: folds 
chaggi23: folds 
Taargeett: folds 
Uncalled bet (2085) returned to gokou56100
gokou56100 collected 550 from pot
gokou56100: doesn't show hand 
*** SUMMARY ***
Total pot 550 | Rake 0 
Seat 1: Dallas433 folded before Flop (didn't bet)
Seat 2: cant_remembr (button) folded before Flop (didn't bet)
Seat 4: Lee-Roy78LS (small blind) folded before Flop
Seat 5: chaggi23 (big blind) folded before Flop
Seat 6: karim199773 folded before Flop (didn't bet)
Seat 7: wolfxx61 folded before Flop (didn't bet)
Seat 8: Taargeett folded before Flop
Seat 9: gokou56100 collected (550)



PokerStars Hand #201225319664: Tournament #2620370251, 8700+1300 Hold'em No Limit - Level IV (50/100) - 2019/06/09 11:24:05 ET
Table '2620370251 1' 9-max Seat #4 is the button
Seat 1: Dallas433 (3455 in chips) 
Seat 2: cant_remembr (4500 in chips) 
Seat 3: roy4ou (1500 in chips) 
Seat 4: Lee-Roy78LS (2325 in chips) 
Seat 5: chaggi23 (4160 in chips) 
Seat 6: karim199773 (3710 in chips) 
Seat 7: wolfxx61 (1320 in chips) is sitting out
Seat 8: Taargeett (3415 in chips) 
Seat 9: gokou56100 (2635 in chips) 
chaggi23: posts small blind 50
karim199773: posts big blind 100
*** HOLE CARDS ***
Dealt to Taargeett [8s Qc]
wolfxx61: folds 
Taargeett: folds 
gokou56100: folds 
Dallas433: calls 100
cant_remembr: calls 100
roy4ou: folds 
Lee-Roy78LS: calls 100
chaggi23: folds 
karim199773: checks 
*** FLOP *** [Jd 2d Jh]
karim199773: checks 
Dallas433: checks 
cant_remembr: checks 
Lee-Roy78LS: checks 
*** TURN *** [Jd 2d Jh] [5s]
karim199773: checks 
Dallas433: bets 100
cant_remembr: folds 
Lee-Roy78LS: folds 
karim199773: raises 300 to 400
Dallas433: raises 2955 to 3355 and is all-in
karim199773: folds 
Uncalled bet (2955) returned to Dallas433
Dallas433 collected 1250 from pot
Dallas433: doesn't show hand 
*** SUMMARY ***
Total pot 1250 | Rake 0 
Board [Jd 2d Jh 5s]
Seat 1: Dallas433 collected (1250)
Seat 2: cant_remembr folded on the Turn
Seat 3: roy4ou folded before Flop (didn't bet)
Seat 4: Lee-Roy78LS (button) folded on the Turn
Seat 5: chaggi23 (small blind) folded before Flop
Seat 6: karim199773 (big blind) folded on the Turn
Seat 7: wolfxx61 folded before Flop (didn't bet)
Seat 8: Taargeett folded before Flop (didn't bet)
Seat 9: gokou56100 folded before Flop (didn't bet)



PokerStars Hand #201225367357: Tournament #2620370251, 8700+1300 Hold'em No Limit - Level V (75/150) - 2019/06/09 11:25:34 ET
Table '2620370251 1' 9-max Seat #5 is the button
Seat 1: Dallas433 (4205 in chips) 
Seat 2: cant_remembr (4400 in chips) 
Seat 3: roy4ou (1500 in chips) 
Seat 4: Lee-Roy78LS (2225 in chips) 
Seat 5: chaggi23 (4110 in chips) 
Seat 6: karim199773 (3210 in chips) 
Seat 7: wolfxx61 (1320 in chips) is sitting out
Seat 8: Taargeett (3415 in chips) 
Seat 9: gokou56100 (2635 in chips) 
karim199773: posts small blind 75
wolfxx61: posts big blind 150
*** HOLE CARDS ***
Dealt to Taargeett [9d 7c]
Taargeett: folds 
gokou56100: folds 
Dallas433: folds 
cant_remembr: calls 150
roy4ou: calls 150
Lee-Roy78LS has timed out
Lee-Roy78LS: folds 
chaggi23: folds 
karim199773: calls 75
wolfxx61: folds 
*** FLOP *** [5s 2h 6d]
karim199773: bets 150
cant_remembr: calls 150
roy4ou: folds 
*** TURN *** [5s 2h 6d] [Ad]
karim199773: bets 150
cant_remembr: calls 150
*** RIVER *** [5s 2h 6d Ad] [Qs]
karim199773: bets 150
cant_remembr: raises 150 to 300
karim199773: calls 150
*** SHOW DOWN ***
cant_remembr: shows [Ah 5c] (two pair, Aces and Fives)
karim199773: mucks hand 
cant_remembr collected 1800 from pot
*** SUMMARY ***
Total pot 1800 | Rake 0 
Board [5s 2h 6d Ad Qs]
Seat 1: Dallas433 folded before Flop (didn't bet)
Seat 2: cant_remembr showed [Ah 5c] and won (1800) with two pair, Aces and Fives
Seat 3: roy4ou folded on the Flop
Seat 4: Lee-Roy78LS folded before Flop (didn't bet)
Seat 5: chaggi23 (button) folded before Flop (didn't bet)
Seat 6: karim199773 (small blind) mucked [Tc Qd]
Seat 7: wolfxx61 (big blind) folded before Flop
Seat 8: Taargeett folded before Flop (didn't bet)
Seat 9: gokou56100 folded before Flop (didn't bet)



PokerStars Hand #201225393695: Tournament #2620370251, 8700+1300 Hold'em No Limit - Level V (75/150) - 2019/06/09 11:26:22 ET
Table '2620370251 1' 9-max Seat #6 is the button
Seat 1: Dallas433 (4205 in chips) 
Seat 2: cant_remembr (5450 in chips) 
Seat 3: roy4ou (1350 in chips) 
Seat 4: Lee-Roy78LS (2225 in chips) is sitting out
Seat 5: chaggi23 (4110 in chips) 
Seat 6: karim199773 (2460 in chips) 
Seat 7: wolfxx61 (1170 in chips) is sitting out
Seat 8: Taargeett (3415 in chips) 
Seat 9: gokou56100 (2635 in chips) 
wolfxx61: posts small blind 75
Taargeett: posts big blind 150
*** HOLE CARDS ***
Dealt to Taargeett [Ad Ks]
gokou56100 has timed out
gokou56100: folds 
Dallas433: raises 300 to 450
cant_remembr: folds 
roy4ou: folds 
Lee-Roy78LS: calls 450
chaggi23: folds 
karim199773: folds 
wolfxx61: folds 
Taargeett: raises 300 to 750
Dallas433: calls 300
Lee-Roy78LS: calls 300
*** FLOP *** [Kd 2c 3h]
Taargeett: bets 1200
Dallas433: folds 
Lee-Roy78LS: folds 
Uncalled bet (1200) returned to Taargeett
Taargeett collected 2325 from pot
Taargeett: doesn't show hand 
*** SUMMARY ***
Total pot 2325 | Rake 0 
Board [Kd 2c 3h]
Seat 1: Dallas433 folded on the Flop
Seat 2: cant_remembr folded before Flop (didn't bet)
Seat 3: roy4ou folded before Flop (didn't bet)
Seat 4: Lee-Roy78LS folded on the Flop
Seat 5: chaggi23 folded before Flop (didn't bet)
Seat 6: karim199773 (button) folded before Flop (didn't bet)
Seat 7: wolfxx61 (small blind) folded before Flop
Seat 8: Taargeett (big blind) collected (2325)
Seat 9: gokou56100 folded before Flop (didn't bet)



PokerStars Hand #201225433157: Tournament #2620370251, 8700+1300 Hold'em No Limit - Level V (75/150) - 2019/06/09 11:27:37 ET
Table '2620370251 1' 9-max Seat #7 is the button
Seat 1: Dallas433 (3455 in chips) 
Seat 2: cant_remembr (5450 in chips) 
Seat 3: roy4ou (1350 in chips) 
Seat 4: Lee-Roy78LS (1475 in chips) 
Seat 5: chaggi23 (4110 in chips) 
Seat 6: karim199773 (2460 in chips) 
Seat 7: wolfxx61 (1095 in chips) is sitting out
Seat 8: Taargeett (4990 in chips) 
Seat 9: gokou56100 (2635 in chips) 
Taargeett: posts small blind 75
gokou56100: posts big blind 150
*** HOLE CARDS ***
Dealt to Taargeett [8c 2c]
Dallas433: raises 300 to 450
cant_remembr: folds 
roy4ou: folds 
Lee-Roy78LS has timed out
Lee-Roy78LS: folds 
chaggi23: folds 
karim199773: calls 450
wolfxx61: folds 
Taargeett: folds 
gokou56100: raises 2185 to 2635 and is all-in
Dallas433: calls 2185
karim199773: folds 
*** FLOP *** [3s 9d 3h]
*** TURN *** [3s 9d 3h] [3d]
*** RIVER *** [3s 9d 3h 3d] [Tc]
*** SHOW DOWN ***
gokou56100: shows [6h 7h] (three of a kind, Threes)
Dallas433: shows [Kh Js] (three of a kind, Threes - King kicker)
Dallas433 collected 5795 from pot
gokou56100 finished the tournament
*** SUMMARY ***
Total pot 5795 | Rake 0 
Board [3s 9d 3h 3d Tc]
Seat 1: Dallas433 showed [Kh Js] and won (5795) with three of a kind, Threes
Seat 2: cant_remembr folded before Flop (didn't bet)
Seat 3: roy4ou folded before Flop (didn't bet)
Seat 4: Lee-Roy78LS folded before Flop (didn't bet)
Seat 5: chaggi23 folded before Flop (didn't bet)
Seat 6: karim199773 folded before Flop
Seat 7: wolfxx61 (button) folded before Flop (didn't bet)
Seat 8: Taargeett (small blind) folded before Flop
Seat 9: gokou56100 (big blind) showed [6h 7h] and lost with three of a kind, Threes



PokerStars Hand #201225459177: Tournament #2620370251, 8700+1300 Hold'em No Limit - Level V (75/150) - 2019/06/09 11:28:25 ET
Table '2620370251 1' 9-max Seat #8 is the button
Seat 1: Dallas433 (6615 in chips) 
Seat 2: cant_remembr (5450 in chips) 
Seat 3: roy4ou (1350 in chips) 
Seat 4: Lee-Roy78LS (1475 in chips) 
Seat 5: chaggi23 (4110 in chips) 
Seat 6: karim199773 (2010 in chips) 
Seat 7: wolfxx61 (1095 in chips) is sitting out
Seat 8: Taargeett (4915 in chips) 
Dallas433: posts small blind 75
cant_remembr: posts big blind 150
*** HOLE CARDS ***
Dealt to Taargeett [Ac 9h]
roy4ou: folds 
Lee-Roy78LS: folds 
chaggi23: calls 150
karim199773: raises 1860 to 2010 and is all-in
wolfxx61: folds 
Taargeett: folds 
Dallas433: folds 
cant_remembr: folds 
chaggi23: folds 
Uncalled bet (1860) returned to karim199773
karim199773 collected 525 from pot
karim199773: doesn't show hand 
*** SUMMARY ***
Total pot 525 | Rake 0 
Seat 1: Dallas433 (small blind) folded before Flop
Seat 2: cant_remembr (big blind) folded before Flop
Seat 3: roy4ou folded before Flop (didn't bet)
Seat 4: Lee-Roy78LS folded before Flop (didn't bet)
Seat 5: chaggi23 folded before Flop
Seat 6: karim199773 collected (525)
Seat 7: wolfxx61 folded before Flop (didn't bet)
Seat 8: Taargeett (button) folded before Flop (didn't bet)



PokerStars Hand #201225475460: Tournament #2620370251, 8700+1300 Hold'em No Limit - Level V (75/150) - 2019/06/09 11:28:56 ET
Table '2620370251 1' 9-max Seat #1 is the button
Seat 1: Dallas433 (6540 in chips) 
Seat 2: cant_remembr (5300 in chips) 
Seat 3: roy4ou (1350 in chips) 
Seat 4: Lee-Roy78LS (1475 in chips) 
Seat 5: chaggi23 (3960 in chips) 
Seat 6: karim199773 (2385 in chips) 
Seat 7: wolfxx61 (1095 in chips) is sitting out
Seat 8: Taargeett (4915 in chips) 
Seat 9: Wisloch111 (1500 in chips) 
cant_remembr: posts small blind 75
roy4ou: posts big blind 150
*** HOLE CARDS ***
Dealt to Taargeett [Td 5c]
Lee-Roy78LS: calls 150
chaggi23: folds 
karim199773: raises 2235 to 2385 and is all-in
wolfxx61: folds 
Taargeett: folds 
Wisloch111: folds 
Dallas433: folds 
cant_remembr: folds 
roy4ou: calls 1200 and is all-in
Lee-Roy78LS: calls 1325 and is all-in
Uncalled bet (910) returned to karim199773
*** FLOP *** [Ad Kc 5h]
*** TURN *** [Ad Kc 5h] [6h]
*** RIVER *** [Ad Kc 5h 6h] [6s]
*** SHOW DOWN ***
Lee-Roy78LS: shows [6c Ac] (a full house, Sixes full of Aces)
karim199773: shows [Ks Js] (two pair, Kings and Sixes)
Lee-Roy78LS collected 250 from side pot
roy4ou: shows [Qd 9h] (a pair of Sixes)
Lee-Roy78LS collected 4125 from main pot
roy4ou finished the tournament
*** SUMMARY ***
Total pot 4375 Main pot 4125. Side pot 250. | Rake 0 
Board [Ad Kc 5h 6h 6s]
Seat 1: Dallas433 (button) folded before Flop (didn't bet)
Seat 2: cant_remembr (small blind) folded before Flop
Seat 3: roy4ou (big blind) showed [Qd 9h] and lost with a pair of Sixes
Seat 4: Lee-Roy78LS showed [6c Ac] and won (4375) with a full house, Sixes full of Aces
Seat 5: chaggi23 folded before Flop (didn't bet)
Seat 6: karim199773 showed [Ks Js] and lost with two pair, Kings and Sixes
Seat 7: wolfxx61 folded before Flop (didn't bet)
Seat 8: Taargeett folded before Flop (didn't bet)
Seat 9: Wisloch111 folded before Flop (didn't bet)



PokerStars Hand #201225499517: Tournament #2620370251, 8700+1300 Hold'em No Limit - Level V (75/150) - 2019/06/09 11:29:41 ET
Table '2620370251 1' 9-max Seat #2 is the button
Seat 1: Dallas433 (6540 in chips) 
Seat 2: cant_remembr (5225 in chips) 
Seat 4: Lee-Roy78LS (4375 in chips) 
Seat 5: chaggi23 (3960 in chips) 
Seat 6: karim199773 (910 in chips) 
Seat 7: wolfxx61 (1095 in chips) is sitting out
Seat 8: Taargeett (4915 in chips) 
Seat 9: Wisloch111 (1500 in chips) 
Lee-Roy78LS: posts small blind 75
chaggi23: posts big blind 150
*** HOLE CARDS ***
Dealt to Taargeett [Qd 7d]
karim199773: raises 760 to 910 and is all-in
wolfxx61: folds 
Taargeett: folds 
Wisloch111: calls 910
Dallas433: folds 
cant_remembr: folds 
Lee-Roy78LS: calls 835
chaggi23: folds 
*** FLOP *** [3h 8h 9h]
Lee-Roy78LS: checks 
Wisloch111: checks 
*** TURN *** [3h 8h 9h] [8s]
Lee-Roy78LS: checks 
Wisloch111: checks 
*** RIVER *** [3h 8h 9h 8s] [4c]
Lee-Roy78LS: checks 
Wisloch111: checks 
*** SHOW DOWN ***
Lee-Roy78LS: shows [As 6d] (a pair of Eights)
karim199773: shows [Ac 4h] (two pair, Eights and Fours)
Wisloch111: shows [9d Kd] (two pair, Nines and Eights)
Wisloch111 collected 2880 from pot
karim199773 finished the tournament
*** SUMMARY ***
Total pot 2880 | Rake 0 
Board [3h 8h 9h 8s 4c]
Seat 1: Dallas433 folded before Flop (didn't bet)
Seat 2: cant_remembr (button) folded before Flop (didn't bet)
Seat 4: Lee-Roy78LS (small blind) showed [As 6d] and lost with a pair of Eights
Seat 5: chaggi23 (big blind) folded before Flop
Seat 6: karim199773 showed [Ac 4h] and lost with two pair, Eights and Fours
Seat 7: wolfxx61 folded before Flop (didn't bet)
Seat 8: Taargeett folded before Flop (didn't bet)
Seat 9: Wisloch111 showed [9d Kd] and won (2880) with two pair, Nines and Eights



PokerStars Hand #201225520674: Tournament #2620370251, 8700+1300 Hold'em No Limit - Level VI (100/200) - 2019/06/09 11:30:20 ET
Table '2620370251 1' 9-max Seat #4 is the button
Seat 1: Dallas433 (6540 in chips) 
Seat 2: cant_remembr (5225 in chips) 
Seat 3: bdabal (1500 in chips) 
Seat 4: Lee-Roy78LS (3465 in chips) 
Seat 5: chaggi23 (3810 in chips) 
Seat 7: wolfxx61 (1095 in chips) is sitting out
Seat 8: Taargeett (4915 in chips) 
Seat 9: Wisloch111 (3470 in chips) 
chaggi23: posts small blind 100
wolfxx61: posts big blind 200
*** HOLE CARDS ***
Dealt to Taargeett [Qc 8h]
Taargeett: folds 
Wisloch111: calls 200
Dallas433: folds 
cant_remembr: folds 
bdabal: folds 
Lee-Roy78LS: folds 
chaggi23: calls 100
wolfxx61: folds 
*** FLOP *** [Ah 2s Jc]
chaggi23: checks 
Wisloch111: bets 600
chaggi23: folds 
Uncalled bet (600) returned to Wisloch111
Wisloch111 collected 600 from pot
Wisloch111: doesn't show hand 
*** SUMMARY ***
Total pot 600 | Rake 0 
Board [Ah 2s Jc]
Seat 1: Dallas433 folded before Flop (didn't bet)
Seat 2: cant_remembr folded before Flop (didn't bet)
Seat 3: bdabal folded before Flop (didn't bet)
Seat 4: Lee-Roy78LS (button) folded before Flop (didn't bet)
Seat 5: chaggi23 (small blind) folded on the Flop
Seat 7: wolfxx61 (big blind) folded before Flop
Seat 8: Taargeett folded before Flop (didn't bet)
Seat 9: Wisloch111 collected (600)



PokerStars Hand #201225539774: Tournament #2620370251, 8700+1300 Hold'em No Limit - Level VI (100/200) - 2019/06/09 11:30:55 ET
Table '2620370251 1' 9-max Seat #5 is the button
Seat 1: Dallas433 (6540 in chips) 
Seat 2: cant_remembr (5225 in chips) 
Seat 3: bdabal (1500 in chips) 
Seat 4: Lee-Roy78LS (3465 in chips) 
Seat 5: chaggi23 (3610 in chips) 
Seat 6: El Guapo14 (1500 in chips) out of hand (moved from another table into small blind)
Seat 7: wolfxx61 (895 in chips) is sitting out
Seat 8: Taargeett (4915 in chips) 
Seat 9: Wisloch111 (3870 in chips) 
El Guapo14 will be allowed to play after the button
wolfxx61: posts small blind 100
Taargeett: posts big blind 200
*** HOLE CARDS ***
Dealt to Taargeett [Th Kc]
Wisloch111: folds 
Dallas433: folds 
cant_remembr: folds 
bdabal: folds 
Lee-Roy78LS: calls 200
chaggi23: folds 
wolfxx61: folds 
Taargeett: checks 
*** FLOP *** [9d Qs 4d]
Taargeett: checks 
Lee-Roy78LS: checks 
*** TURN *** [9d Qs 4d] [6s]
Taargeett: bets 200
Lee-Roy78LS has timed out
Lee-Roy78LS: folds 
Uncalled bet (200) returned to Taargeett
Taargeett collected 500 from pot
Taargeett: doesn't show hand 
*** SUMMARY ***
Total pot 500 | Rake 0 
Board [9d Qs 4d 6s]
Seat 1: Dallas433 folded before Flop (didn't bet)
Seat 2: cant_remembr folded before Flop (didn't bet)
Seat 3: bdabal folded before Flop (didn't bet)
Seat 4: Lee-Roy78LS folded on the Turn
Seat 5: chaggi23 (button) folded before Flop (didn't bet)
Seat 7: wolfxx61 (small blind) folded before Flop
Seat 8: Taargeett (big blind) collected (500)
Seat 9: Wisloch111 folded before Flop (didn't bet)



PokerStars Hand #201225569563: Tournament #2620370251, 8700+1300 Hold'em No Limit - Level VI (100/200) - 2019/06/09 11:31:50 ET
Table '2620370251 1' 9-max Seat #7 is the button
Seat 1: Dallas433 (6540 in chips) 
Seat 2: cant_remembr (5225 in chips) 
Seat 3: bdabal (1500 in chips) 
Seat 4: Lee-Roy78LS (3265 in chips) is sitting out
Seat 5: chaggi23 (3610 in chips) 
Seat 6: El Guapo14 (1500 in chips) 
Seat 7: wolfxx61 (795 in chips) is sitting out
Seat 8: Taargeett (5215 in chips) 
Seat 9: Wisloch111 (3870 in chips) 
Taargeett: posts small blind 100
Wisloch111: posts big blind 200
*** HOLE CARDS ***
Dealt to Taargeett [4d 2h]
Dallas433: raises 400 to 600
cant_remembr: folds 
bdabal: folds 
Lee-Roy78LS: calls 600
chaggi23: calls 600
El Guapo14: folds 
wolfxx61: folds 
Taargeett: folds 
Wisloch111: folds 
*** FLOP *** [2d 9h 3c]
Dallas433: bets 200
Lee-Roy78LS: calls 200
chaggi23: raises 2810 to 3010 and is all-in
Dallas433: folds 
Lee-Roy78LS: folds 
Uncalled bet (2810) returned to chaggi23
chaggi23 collected 2700 from pot
chaggi23: doesn't show hand 
*** SUMMARY ***
Total pot 2700 | Rake 0 
Board [2d 9h 3c]
Seat 1: Dallas433 folded on the Flop
Seat 2: cant_remembr folded before Flop (didn't bet)
Seat 3: bdabal folded before Flop (didn't bet)
Seat 4: Lee-Roy78LS folded on the Flop
Seat 5: chaggi23 collected (2700)
Seat 6: El Guapo14 folded before Flop (didn't bet)
Seat 7: wolfxx61 (button) folded before Flop (didn't bet)
Seat 8: Taargeett (small blind) folded before Flop
Seat 9: Wisloch111 (big blind) folded before Flop



PokerStars Hand #201225591143: Tournament #2620370251, 8700+1300 Hold'em No Limit - Level VI (100/200) - 2019/06/09 11:32:29 ET
Table '2620370251 1' 9-max Seat #8 is the button
Seat 1: Dallas433 (5740 in chips) 
Seat 2: cant_remembr (5225 in chips) 
Seat 3: bdabal (1500 in chips) 
Seat 4: Lee-Roy78LS (2465 in chips) 
Seat 5: chaggi23 (5510 in chips) 
Seat 6: El Guapo14 (1500 in chips) 
Seat 7: wolfxx61 (795 in chips) is sitting out
Seat 8: Taargeett (5115 in chips) 
Seat 9: Wisloch111 (3670 in chips) 
Wisloch111: posts small blind 100
Dallas433: posts big blind 200
*** HOLE CARDS ***
Dealt to Taargeett [4d Kc]
cant_remembr: folds 
bdabal: folds 
Lee-Roy78LS: raises 200 to 400
chaggi23: calls 400
El Guapo14: calls 400
wolfxx61: folds 
Taargeett: folds 
Wisloch111: raises 600 to 1000
Dallas433: folds 
Lee-Roy78LS: calls 600
chaggi23: calls 600
El Guapo14: calls 600
*** FLOP *** [9h 5c 5h]
Wisloch111: checks 
Lee-Roy78LS has timed out
Lee-Roy78LS: checks 
chaggi23: checks 
El Guapo14: bets 500 and is all-in
Wisloch111: calls 500
Lee-Roy78LS: raises 500 to 1000
chaggi23: folds 
Wisloch111: calls 500
*** TURN *** [9h 5c 5h] [9d]
Wisloch111: checks 
Lee-Roy78LS: bets 465 and is all-in
Wisloch111: calls 465
*** RIVER *** [9h 5c 5h 9d] [6h]
*** SHOW DOWN ***
Wisloch111: shows [Ah As] (two pair, Aces and Nines)
Lee-Roy78LS: shows [8s 8c] (two pair, Nines and Eights)
Wisloch111 collected 1930 from side pot
El Guapo14: shows [7h 7c] (two pair, Nines and Sevens)
Wisloch111 collected 5700 from main pot
Lee-Roy78LS finished the tournament
El Guapo14 finished the tournament
*** SUMMARY ***
Total pot 7630 Main pot 5700. Side pot 1930. | Rake 0 
Board [9h 5c 5h 9d 6h]
Seat 1: Dallas433 (big blind) folded before Flop
Seat 2: cant_remembr folded before Flop (didn't bet)
Seat 3: bdabal folded before Flop (didn't bet)
Seat 4: Lee-Roy78LS showed [8s 8c] and lost with two pair, Nines and Eights
Seat 5: chaggi23 folded on the Flop
Seat 6: El Guapo14 showed [7h 7c] and lost with two pair, Nines and Sevens
Seat 7: wolfxx61 folded before Flop (didn't bet)
Seat 8: Taargeett (button) folded before Flop (didn't bet)
Seat 9: Wisloch111 (small blind) showed [Ah As] and won (7630) with two pair, Aces and Nines



PokerStars Hand #201225651499: Tournament #2620370251, 8700+1300 Hold'em No Limit - Level VI (100/200) - 2019/06/09 11:34:21 ET
Table '2620370251 1' 9-max Seat #9 is the button
Seat 1: Dallas433 (5540 in chips) 
Seat 2: cant_remembr (5225 in chips) 
Seat 3: bdabal (1500 in chips) 
Seat 4: balls5211 (1500 in chips) 
Seat 5: chaggi23 (4510 in chips) 
Seat 7: wolfxx61 (795 in chips) is sitting out
Seat 8: Taargeett (5115 in chips) 
Seat 9: Wisloch111 (8835 in chips) 
Dallas433: posts small blind 100
cant_remembr: posts big blind 200
*** HOLE CARDS ***
Dealt to Taargeett [2s 2h]
bdabal: folds 
balls5211: folds 
chaggi23: folds 
wolfxx61: folds 
Taargeett: raises 200 to 400
Wisloch111: folds 
Dallas433: folds 
cant_remembr: folds 
Uncalled bet (200) returned to Taargeett
Taargeett collected 500 from pot
Taargeett: doesn't show hand 
*** SUMMARY ***
Total pot 500 | Rake 0 
Seat 1: Dallas433 (small blind) folded before Flop
Seat 2: cant_remembr (big blind) folded before Flop
Seat 3: bdabal folded before Flop (didn't bet)
Seat 4: balls5211 folded before Flop (didn't bet)
Seat 5: chaggi23 folded before Flop (didn't bet)
Seat 7: wolfxx61 folded before Flop (didn't bet)
Seat 8: Taargeett collected (500)
Seat 9: Wisloch111 (button) folded before Flop (didn't bet)



PokerStars Hand #201225663748: Tournament #2620370251, 8700+1300 Hold'em No Limit - Level VI (100/200) - 2019/06/09 11:34:43 ET
Table '2620370251 1' 9-max Seat #1 is the button
Seat 1: Dallas433 (5440 in chips) 
Seat 2: cant_remembr (5025 in chips) 
Seat 3: bdabal (1500 in chips) 
Seat 4: balls5211 (1500 in chips) 
Seat 5: chaggi23 (4510 in chips) 
Seat 7: wolfxx61 (795 in chips) is sitting out
Seat 8: Taargeett (5415 in chips) 
Seat 9: Wisloch111 (8835 in chips) 
cant_remembr: posts small blind 100
bdabal: posts big blind 200
*** HOLE CARDS ***
Dealt to Taargeett [Qh 6d]
balls5211: folds 
chaggi23: raises 4310 to 4510 and is all-in
wolfxx61: folds 
Taargeett: folds 
Wisloch111: folds 
Dallas433: folds 
cant_remembr: folds 
bdabal: folds 
Uncalled bet (4310) returned to chaggi23
chaggi23 collected 500 from pot
chaggi23: doesn't show hand 
*** SUMMARY ***
Total pot 500 | Rake 0 
Seat 1: Dallas433 (button) folded before Flop (didn't bet)
Seat 2: cant_remembr (small blind) folded before Flop
Seat 3: bdabal (big blind) folded before Flop
Seat 4: balls5211 folded before Flop (didn't bet)
Seat 5: chaggi23 collected (500)
Seat 7: wolfxx61 folded before Flop (didn't bet)
Seat 8: Taargeett folded before Flop (didn't bet)
Seat 9: Wisloch111 folded before Flop (didn't bet)



PokerStars Hand #201225683461: Tournament #2620370251, 8700+1300 Hold'em No Limit - Level VII (125/250) - 2019/06/09 11:35:19 ET
Table '2620370251 1' 9-max Seat #2 is the button
Seat 1: Dallas433 (5440 in chips) 
Seat 2: cant_remembr (4925 in chips) 
Seat 3: bdabal (1300 in chips) 
Seat 4: balls5211 (1500 in chips) 
Seat 5: chaggi23 (4810 in chips) 
Seat 6: Radiant04 (1500 in chips) 
Seat 7: wolfxx61 (795 in chips) 
Seat 8: Taargeett (5415 in chips) 
Seat 9: Wisloch111 (8835 in chips) 
Dallas433: posts the ante 25
cant_remembr: posts the ante 25
bdabal: posts the ante 25
balls5211: posts the ante 25
chaggi23: posts the ante 25
Radiant04: posts the ante 25
wolfxx61: posts the ante 25
Taargeett: posts the ante 25
Wisloch111: posts the ante 25
bdabal: posts small blind 125
balls5211: posts big blind 250
*** HOLE CARDS ***
Dealt to Taargeett [Ts 2c]
chaggi23: folds 
Radiant04: folds 
wolfxx61: folds 
Taargeett: folds 
Wisloch111: calls 250
Dallas433: folds 
cant_remembr: folds 
bdabal: folds 
balls5211: checks 
*** FLOP *** [Kh 2d 6d]
balls5211: checks 
Wisloch111: bets 750
balls5211: folds 
Uncalled bet (750) returned to Wisloch111
Wisloch111 collected 850 from pot
Wisloch111: doesn't show hand 
*** SUMMARY ***
Total pot 850 | Rake 0 
Board [Kh 2d 6d]
Seat 1: Dallas433 folded before Flop (didn't bet)
Seat 2: cant_remembr (button) folded before Flop (didn't bet)
Seat 3: bdabal (small blind) folded before Flop
Seat 4: balls5211 (big blind) folded on the Flop
Seat 5: chaggi23 folded before Flop (didn't bet)
Seat 6: Radiant04 folded before Flop (didn't bet)
Seat 7: wolfxx61 folded before Flop (didn't bet)
Seat 8: Taargeett folded before Flop (didn't bet)
Seat 9: Wisloch111 collected (850)



PokerStars Hand #201225709624: Tournament #2620370251, 8700+1300 Hold'em No Limit - Level VII (125/250) - 2019/06/09 11:36:07 ET
Table '2620370251 1' 9-max Seat #3 is the button
Seat 1: Dallas433 (5415 in chips) 
Seat 2: cant_remembr (4900 in chips) 
Seat 3: bdabal (1150 in chips) 
Seat 4: balls5211 (1225 in chips) 
Seat 5: chaggi23 (4785 in chips) 
Seat 6: Radiant04 (1475 in chips) 
Seat 7: wolfxx61 (770 in chips) 
Seat 8: Taargeett (5390 in chips) 
Seat 9: Wisloch111 (9410 in chips) 
Dallas433: posts the ante 25
cant_remembr: posts the ante 25
bdabal: posts the ante 25
balls5211: posts the ante 25
chaggi23: posts the ante 25
Radiant04: posts the ante 25
wolfxx61: posts the ante 25
Taargeett: posts the ante 25
Wisloch111: posts the ante 25
balls5211: posts small blind 125
chaggi23: posts big blind 250
*** HOLE CARDS ***
Dealt to Taargeett [4c Js]
Radiant04: folds 
wolfxx61: folds 
Taargeett: folds 
Wisloch111: calls 250
Dallas433: folds 
cant_remembr: folds 
bdabal: folds 
balls5211: calls 125
chaggi23: checks 
*** FLOP *** [4d Th Ac]
balls5211: checks 
chaggi23: checks 
Wisloch111: bets 500
balls5211: folds 
chaggi23: calls 500
*** TURN *** [4d Th Ac] [6d]
chaggi23: checks 
Wisloch111: checks 
*** RIVER *** [4d Th Ac 6d] [Ts]
chaggi23: bets 4010 and is all-in
Wisloch111: calls 4010
*** SHOW DOWN ***
chaggi23: shows [6s 6c] (a full house, Sixes full of Tens)
Wisloch111: shows [Ad 2d] (two pair, Aces and Tens)
chaggi23 collected 9995 from pot
*** SUMMARY ***
Total pot 9995 | Rake 0 
Board [4d Th Ac 6d Ts]
Seat 1: Dallas433 folded before Flop (didn't bet)
Seat 2: cant_remembr folded before Flop (didn't bet)
Seat 3: bdabal (button) folded before Flop (didn't bet)
Seat 4: balls5211 (small blind) folded on the Flop
Seat 5: chaggi23 (big blind) showed [6s 6c] and won (9995) with a full house, Sixes full of Tens
Seat 6: Radiant04 folded before Flop (didn't bet)
Seat 7: wolfxx61 folded before Flop (didn't bet)
Seat 8: Taargeett folded before Flop (didn't bet)
Seat 9: Wisloch111 showed [Ad 2d] and lost with two pair, Aces and Tens



PokerStars Hand #201225750861: Tournament #2620370251, 8700+1300 Hold'em No Limit - Level VII (125/250) - 2019/06/09 11:37:22 ET
Table '2620370251 1' 9-max Seat #4 is the button
Seat 1: Dallas433 (5390 in chips) 
Seat 2: cant_remembr (4875 in chips) 
Seat 3: bdabal (1125 in chips) 
Seat 4: balls5211 (950 in chips) 
Seat 5: chaggi23 (9995 in chips) 
Seat 6: Radiant04 (1450 in chips) 
Seat 7: wolfxx61 (745 in chips) 
Seat 8: Taargeett (5365 in chips) 
Seat 9: Wisloch111 (4625 in chips) 
Dallas433: posts the ante 25
cant_remembr: posts the ante 25
bdabal: posts the ante 25
balls5211: posts the ante 25
chaggi23: posts the ante 25
Radiant04: posts the ante 25
wolfxx61: posts the ante 25
Taargeett: posts the ante 25
Wisloch111: posts the ante 25
chaggi23: posts small blind 125
Radiant04: posts big blind 250
*** HOLE CARDS ***
Dealt to Taargeett [6d 6s]
wolfxx61: folds 
Taargeett: raises 250 to 500
Wisloch111: calls 500
Dallas433: folds 
cant_remembr: folds 
bdabal: folds 
balls5211: raises 425 to 925 and is all-in
chaggi23: folds 
Radiant04: folds 
Taargeett: calls 425
Wisloch111: calls 425
*** FLOP *** [8s Qc 9s]
Taargeett: checks 
Wisloch111: checks 
*** TURN *** [8s Qc 9s] [As]
Taargeett: checks 
Wisloch111: checks 
*** RIVER *** [8s Qc 9s As] [2h]
Taargeett: bets 1500
Wisloch111: calls 1500
*** SHOW DOWN ***
Taargeett: shows [6d 6s] (a pair of Sixes)
Wisloch111: shows [9c Jh] (a pair of Nines)
Wisloch111 collected 3000 from side pot
balls5211: shows [Jd Qd] (a pair of Queens)
balls5211 collected 3375 from main pot
*** SUMMARY ***
Total pot 6375 Main pot 3375. Side pot 3000. | Rake 0 
Board [8s Qc 9s As 2h]
Seat 1: Dallas433 folded before Flop (didn't bet)
Seat 2: cant_remembr folded before Flop (didn't bet)
Seat 3: bdabal folded before Flop (didn't bet)
Seat 4: balls5211 (button) showed [Jd Qd] and won (3375) with a pair of Queens
Seat 5: chaggi23 (small blind) folded before Flop
Seat 6: Radiant04 (big blind) folded before Flop
Seat 7: wolfxx61 folded before Flop (didn't bet)
Seat 8: Taargeett showed [6d 6s] and lost with a pair of Sixes
Seat 9: Wisloch111 showed [9c Jh] and won (3000) with a pair of Nines



PokerStars Hand #201225784448: Tournament #2620370251, 8700+1300 Hold'em No Limit - Level VII (125/250) - 2019/06/09 11:38:24 ET
Table '2620370251 1' 9-max Seat #5 is the button
Seat 1: Dallas433 (5365 in chips) 
Seat 2: cant_remembr (4850 in chips) is sitting out
Seat 3: bdabal (1100 in chips) 
Seat 4: balls5211 (3375 in chips) 
Seat 5: chaggi23 (9845 in chips) 
Seat 6: Radiant04 (1175 in chips) 
Seat 7: wolfxx61 (720 in chips) 
Seat 8: Taargeett (2915 in chips) 
Seat 9: Wisloch111 (5175 in chips) 
Dallas433: posts the ante 25
cant_remembr: posts the ante 25
bdabal: posts the ante 25
balls5211: posts the ante 25
chaggi23: posts the ante 25
Radiant04: posts the ante 25
wolfxx61: posts the ante 25
Taargeett: posts the ante 25
Wisloch111: posts the ante 25
Radiant04: posts small blind 125
wolfxx61: posts big blind 250
*** HOLE CARDS ***
Dealt to Taargeett [5h 8s]
Taargeett: folds 
Wisloch111: folds 
Dallas433: folds 
cant_remembr: folds 
bdabal: folds 
balls5211: calls 250
chaggi23: folds 
Radiant04: raises 900 to 1150 and is all-in
wolfxx61: folds 
balls5211: calls 900
*** FLOP *** [6d Qh Qc]
*** TURN *** [6d Qh Qc] [3d]
*** RIVER *** [6d Qh Qc 3d] [7h]
*** SHOW DOWN ***
Radiant04: shows [9c As] (a pair of Queens)
balls5211: shows [3h 3s] (a full house, Threes full of Queens)
balls5211 collected 2775 from pot
Radiant04 finished the tournament in 298th place
*** SUMMARY ***
Total pot 2775 | Rake 0 
Board [6d Qh Qc 3d 7h]
Seat 1: Dallas433 folded before Flop (didn't bet)
Seat 2: cant_remembr folded before Flop (didn't bet)
Seat 3: bdabal folded before Flop (didn't bet)
Seat 4: balls5211 showed [3h 3s] and won (2775) with a full house, Threes full of Queens
Seat 5: chaggi23 (button) folded before Flop (didn't bet)
Seat 6: Radiant04 (small blind) showed [9c As] and lost with a pair of Queens
Seat 7: wolfxx61 (big blind) folded before Flop
Seat 8: Taargeett folded before Flop (didn't bet)
Seat 9: Wisloch111 folded before Flop (didn't bet)



PokerStars Hand #201225819974: Tournament #2620370251, 8700+1300 Hold'em No Limit - Level VII (125/250) - 2019/06/09 11:39:29 ET
Table '2620370251 32' 9-max Seat #2 is the button
Seat 1: Taargeett (2890 in chips) 
Seat 2: clayjay24 (3855 in chips) 
Seat 3: GeoGil233 (2832 in chips) 
Seat 4: MIMI6729 (530 in chips) 
Seat 5: optimus02 (380 in chips) 
Seat 6: poffy7 (1795 in chips) 
Seat 7: Benk_51 (4093 in chips) 
Seat 8: Big Rick 055 (3050 in chips) 
Seat 9: nikel51 (5590 in chips) 
Taargeett: posts the ante 25
clayjay24: posts the ante 25
GeoGil233: posts the ante 25
MIMI6729: posts the ante 25
optimus02: posts the ante 25
poffy7: posts the ante 25
Benk_51: posts the ante 25
Big Rick 055: posts the ante 25
nikel51: posts the ante 25
GeoGil233: posts small blind 125
MIMI6729: posts big blind 250
*** HOLE CARDS ***
Dealt to Taargeett [5h 7d]
optimus02: raises 105 to 355 and is all-in
poffy7: folds 
Benk_51: folds 
Big Rick 055: calls 355
nikel51: calls 355
Taargeett: folds 
clayjay24: folds 
GeoGil233: folds 
MIMI6729: calls 105
*** FLOP *** [6h 3s 6d]
MIMI6729: bets 150 and is all-in
Big Rick 055: calls 150
nikel51: calls 150
*** TURN *** [6h 3s 6d] [5s]
Big Rick 055: checks 
nikel51: checks 
*** RIVER *** [6h 3s 6d 5s] [Kd]
Big Rick 055: checks 
nikel51: bets 2250
Big Rick 055: folds 
Uncalled bet (2250) returned to nikel51
*** SHOW DOWN ***
nikel51: shows [Th Ks] (two pair, Kings and Sixes)
MIMI6729: shows [2c 9d] (a pair of Sixes)
nikel51 collected 450 from side pot
optimus02: shows [7c 8h] (a pair of Sixes)
nikel51 collected 1770 from main pot
MIMI6729 finished the tournament in 278th place
optimus02 finished the tournament in 279th place
*** SUMMARY ***
Total pot 2220 Main pot 1770. Side pot 450. | Rake 0 
Board [6h 3s 6d 5s Kd]
Seat 1: Taargeett folded before Flop (didn't bet)
Seat 2: clayjay24 (button) folded before Flop (didn't bet)
Seat 3: GeoGil233 (small blind) folded before Flop
Seat 4: MIMI6729 (big blind) showed [2c 9d] and lost with a pair of Sixes
Seat 5: optimus02 showed [7c 8h] and lost with a pair of Sixes
Seat 6: poffy7 folded before Flop (didn't bet)
Seat 7: Benk_51 folded before Flop (didn't bet)
Seat 8: Big Rick 055 folded on the River
Seat 9: nikel51 showed [Th Ks] and won (2220) with two pair, Kings and Sixes



PokerStars Hand #201225846502: Tournament #2620370251, 8700+1300 Hold'em No Limit - Level VIII (150/300) - 2019/06/09 11:40:19 ET
Table '2620370251 32' 9-max Seat #3 is the button
Seat 1: Taargeett (2865 in chips) 
Seat 2: clayjay24 (3830 in chips) 
Seat 3: GeoGil233 (2682 in chips) 
Seat 5: fetis999 (8383 in chips) out of hand (moved from another table into small blind)
Seat 6: poffy7 (1770 in chips) 
Seat 7: Benk_51 (4068 in chips) 
Seat 8: Big Rick 055 (2520 in chips) 
Seat 9: nikel51 (7280 in chips) 
fetis999 will be allowed to play after the button
Taargeett: posts the ante 25
clayjay24: posts the ante 25
GeoGil233: posts the ante 25
poffy7: posts the ante 25
Benk_51: posts the ante 25
Big Rick 055: posts the ante 25
nikel51: posts the ante 25
poffy7: posts small blind 150
Benk_51: posts big blind 300
*** HOLE CARDS ***
Dealt to Taargeett [9c Ac]
Big Rick 055: folds 
nikel51: folds 
Taargeett: raises 300 to 600
clayjay24: folds 
GeoGil233: folds 
poffy7: folds 
Benk_51: folds 
Uncalled bet (300) returned to Taargeett
Taargeett collected 925 from pot
Taargeett: doesn't show hand 
*** SUMMARY ***
Total pot 925 | Rake 0 
Seat 1: Taargeett collected (925)
Seat 2: clayjay24 folded before Flop (didn't bet)
Seat 3: GeoGil233 (button) folded before Flop (didn't bet)
Seat 6: poffy7 (small blind) folded before Flop
Seat 7: Benk_51 (big blind) folded before Flop
Seat 8: Big Rick 055 folded before Flop (didn't bet)
Seat 9: nikel51 folded before Flop (didn't bet)



PokerStars Hand #201225855826: Tournament #2620370251, 8700+1300 Hold'em No Limit - Level VIII (150/300) - 2019/06/09 11:40:36 ET
Table '2620370251 32' 9-max Seat #6 is the button
Seat 1: Taargeett (3465 in chips) 
Seat 2: clayjay24 (3805 in chips) 
Seat 3: GeoGil233 (2657 in chips) 
Seat 4: hchchcvgcggc (2670 in chips) 
Seat 5: fetis999 (8383 in chips) 
Seat 6: poffy7 (1595 in chips) 
Seat 7: Benk_51 (3743 in chips) 
Seat 8: Big Rick 055 (2495 in chips) 
Seat 9: nikel51 (7255 in chips) 
Taargeett: posts the ante 25
clayjay24: posts the ante 25
GeoGil233: posts the ante 25
hchchcvgcggc: posts the ante 25
fetis999: posts the ante 25
poffy7: posts the ante 25
Benk_51: posts the ante 25
Big Rick 055: posts the ante 25
nikel51: posts the ante 25
Benk_51: posts small blind 150
Big Rick 055: posts big blind 300
*** HOLE CARDS ***
Dealt to Taargeett [Jh 6c]
nikel51: folds 
Taargeett: folds 
clayjay24: folds 
GeoGil233: folds 
hchchcvgcggc: folds 
fetis999: folds 
poffy7: calls 300
Benk_51: folds 
Big Rick 055: checks 
*** FLOP *** [9c 3c 5d]
Big Rick 055: checks 
poffy7: bets 1200
Big Rick 055: folds 
Uncalled bet (1200) returned to poffy7
poffy7 collected 975 from pot
poffy7: doesn't show hand 
*** SUMMARY ***
Total pot 975 | Rake 0 
Board [9c 3c 5d]
Seat 1: Taargeett folded before Flop (didn't bet)
Seat 2: clayjay24 folded before Flop (didn't bet)
Seat 3: GeoGil233 folded before Flop (didn't bet)
Seat 4: hchchcvgcggc folded before Flop (didn't bet)
Seat 5: fetis999 folded before Flop (didn't bet)
Seat 6: poffy7 (button) collected (975)
Seat 7: Benk_51 (small blind) folded before Flop
Seat 8: Big Rick 055 (big blind) folded on the Flop
Seat 9: nikel51 folded before Flop (didn't bet)



PokerStars Hand #201225873151: Tournament #2620370251, 8700+1300 Hold'em No Limit - Level VIII (150/300) - 2019/06/09 11:41:08 ET
Table '2620370251 32' 9-max Seat #7 is the button
Seat 1: Taargeett (3440 in chips) 
Seat 2: clayjay24 (3780 in chips) 
Seat 3: GeoGil233 (2632 in chips) 
Seat 4: hchchcvgcggc (2645 in chips) 
Seat 5: fetis999 (8358 in chips) 
Seat 6: poffy7 (2245 in chips) 
Seat 7: Benk_51 (3568 in chips) 
Seat 8: Big Rick 055 (2170 in chips) 
Seat 9: nikel51 (7230 in chips) 
Taargeett: posts the ante 25
clayjay24: posts the ante 25
GeoGil233: posts the ante 25
hchchcvgcggc: posts the ante 25
fetis999: posts the ante 25
poffy7: posts the ante 25
Benk_51: posts the ante 25
Big Rick 055: posts the ante 25
nikel51: posts the ante 25
Big Rick 055: posts small blind 150
nikel51: posts big blind 300
*** HOLE CARDS ***
Dealt to Taargeett [6d 9c]
Taargeett: folds 
clayjay24: folds 
GeoGil233: folds 
hchchcvgcggc: raises 2320 to 2620 and is all-in
fetis999: folds 
poffy7: folds 
Benk_51: folds 
Big Rick 055: folds 
nikel51: folds 
Uncalled bet (2320) returned to hchchcvgcggc
hchchcvgcggc collected 975 from pot
*** SUMMARY ***
Total pot 975 | Rake 0 
Seat 1: Taargeett folded before Flop (didn't bet)
Seat 2: clayjay24 folded before Flop (didn't bet)
Seat 3: GeoGil233 folded before Flop (didn't bet)
Seat 4: hchchcvgcggc collected (975)
Seat 5: fetis999 folded before Flop (didn't bet)
Seat 6: poffy7 folded before Flop (didn't bet)
Seat 7: Benk_51 (button) folded before Flop (didn't bet)
Seat 8: Big Rick 055 (small blind) folded before Flop
Seat 9: nikel51 (big blind) folded before Flop



PokerStars Hand #201225886342: Tournament #2620370251, 8700+1300 Hold'em No Limit - Level VIII (150/300) - 2019/06/09 11:41:32 ET
Table '2620370251 32' 9-max Seat #8 is the button
Seat 1: Taargeett (3415 in chips) 
Seat 2: clayjay24 (3755 in chips) 
Seat 3: GeoGil233 (2607 in chips) 
Seat 4: hchchcvgcggc (3295 in chips) 
Seat 5: fetis999 (8333 in chips) 
Seat 6: poffy7 (2220 in chips) 
Seat 7: Benk_51 (3543 in chips) 
Seat 8: Big Rick 055 (1995 in chips) 
Seat 9: nikel51 (6905 in chips) 
Taargeett: posts the ante 25
clayjay24: posts the ante 25
GeoGil233: posts the ante 25
hchchcvgcggc: posts the ante 25
fetis999: posts the ante 25
poffy7: posts the ante 25
Benk_51: posts the ante 25
Big Rick 055: posts the ante 25
nikel51: posts the ante 25
nikel51: posts small blind 150
Taargeett: posts big blind 300
*** HOLE CARDS ***
Dealt to Taargeett [Qc Kc]
clayjay24: calls 300
GeoGil233: folds 
hchchcvgcggc: folds 
fetis999: folds 
poffy7: calls 300
Benk_51: calls 300
Big Rick 055: calls 300
nikel51: calls 150
Taargeett: raises 600 to 900
clayjay24: calls 600
poffy7: calls 600
Benk_51: calls 600
Big Rick 055: raises 1070 to 1970 and is all-in
nikel51: folds 
Taargeett: raises 1070 to 3040
clayjay24: folds 
poffy7: calls 1295 and is all-in
Benk_51: folds 
Uncalled bet (845) returned to Taargeett
*** FLOP *** [9d 5c Ac]
*** TURN *** [9d 5c Ac] [6c]
*** RIVER *** [9d 5c Ac 6c] [9s]
*** SHOW DOWN ***
Taargeett: shows [Qc Kc] (a flush, Ace high)
poffy7: shows [Ah 5h] (two pair, Aces and Nines)
Taargeett collected 450 from side pot
Big Rick 055: shows [3c 4c] (a flush, Ace high - lower cards)
Taargeett collected 8235 from main pot
poffy7 finished the tournament in 249th place
Big Rick 055 finished the tournament in 250th place
*** SUMMARY ***
Total pot 8685 Main pot 8235. Side pot 450. | Rake 0 
Board [9d 5c Ac 6c 9s]
Seat 1: Taargeett (big blind) showed [Qc Kc] and won (8685) with a flush, Ace high
Seat 2: clayjay24 folded before Flop
Seat 3: GeoGil233 folded before Flop (didn't bet)
Seat 4: hchchcvgcggc folded before Flop (didn't bet)
Seat 5: fetis999 folded before Flop (didn't bet)
Seat 6: poffy7 showed [Ah 5h] and lost with two pair, Aces and Nines
Seat 7: Benk_51 folded before Flop
Seat 8: Big Rick 055 (button) showed [3c 4c] and lost with a flush, Ace high
Seat 9: nikel51 (small blind) folded before Flop



PokerStars Hand #201225911289: Tournament #2620370251, 8700+1300 Hold'em No Limit - Level VIII (150/300) - 2019/06/09 11:42:17 ET
Table '2620370251 32' 9-max Seat #9 is the button
Seat 1: Taargeett (9880 in chips) 
Seat 2: clayjay24 (2830 in chips) 
Seat 3: GeoGil233 (2582 in chips) 
Seat 4: hchchcvgcggc (3270 in chips) 
Seat 5: fetis999 (8308 in chips) 
Seat 7: Benk_51 (2618 in chips) 
Seat 8: EdwinLizara (2275 in chips) 
Seat 9: nikel51 (6580 in chips) 
Taargeett: posts the ante 25
clayjay24: posts the ante 25
GeoGil233: posts the ante 25
hchchcvgcggc: posts the ante 25
fetis999: posts the ante 25
Benk_51: posts the ante 25
EdwinLizara: posts the ante 25
nikel51: posts the ante 25
Taargeett: posts small blind 150
clayjay24: posts big blind 300
*** HOLE CARDS ***
Dealt to Taargeett [Ts 7d]
GeoGil233: folds 
hchchcvgcggc is disconnected 
hchchcvgcggc has timed out while being disconnected
hchchcvgcggc: folds 
fetis999: calls 300
Benk_51: folds 
EdwinLizara: folds 
nikel51: folds 
Taargeett: folds 
clayjay24: checks 
*** FLOP *** [6h Qh 2h]
clayjay24: checks 
fetis999: bets 300
clayjay24: folds 
Uncalled bet (300) returned to fetis999
fetis999 collected 950 from pot
fetis999: doesn't show hand 
*** SUMMARY ***
Total pot 950 | Rake 0 
Board [6h Qh 2h]
Seat 1: Taargeett (small blind) folded before Flop
Seat 2: clayjay24 (big blind) folded on the Flop
Seat 3: GeoGil233 folded before Flop (didn't bet)
Seat 4: hchchcvgcggc folded before Flop (didn't bet)
Seat 5: fetis999 collected (950)
Seat 7: Benk_51 folded before Flop (didn't bet)
Seat 8: EdwinLizara folded before Flop (didn't bet)
Seat 9: nikel51 (button) folded before Flop (didn't bet)



PokerStars Hand #201225938890: Tournament #2620370251, 8700+1300 Hold'em No Limit - Level VIII (150/300) - 2019/06/09 11:43:09 ET
Table '2620370251 32' 9-max Seat #1 is the button
Seat 1: Taargeett (9705 in chips) 
Seat 2: clayjay24 (2505 in chips) 
Seat 3: GeoGil233 (2557 in chips) 
Seat 4: hchchcvgcggc (3245 in chips) is sitting out
Seat 5: fetis999 (8933 in chips) 
Seat 6: 70egor70 (6993 in chips) 
Seat 7: Benk_51 (2593 in chips) 
Seat 8: EdwinLizara (2250 in chips) 
Seat 9: nikel51 (6555 in chips) 
Taargeett: posts the ante 25
clayjay24: posts the ante 25
GeoGil233: posts the ante 25
hchchcvgcggc: posts the ante 25
fetis999: posts the ante 25
70egor70: posts the ante 25
Benk_51: posts the ante 25
EdwinLizara: posts the ante 25
nikel51: posts the ante 25
clayjay24: posts small blind 150
GeoGil233: posts big blind 300
*** HOLE CARDS ***
Dealt to Taargeett [Qd 3s]
hchchcvgcggc: folds 
fetis999: folds 
70egor70: calls 300
Benk_51: folds 
EdwinLizara: calls 300
nikel51: raises 1575 to 1875
Taargeett: folds 
clayjay24: folds 
GeoGil233: folds 
70egor70: folds 
EdwinLizara: calls 1575
*** FLOP *** [5d Jc Ac]
EdwinLizara: checks 
nikel51: bets 2400
EdwinLizara: calls 350 and is all-in
Uncalled bet (2050) returned to nikel51
*** TURN *** [5d Jc Ac] [2d]
*** RIVER *** [5d Jc Ac 2d] [3d]
*** SHOW DOWN ***
EdwinLizara: shows [Ah Th] (a pair of Aces)
nikel51: shows [Kc Qc] (high card Ace)
EdwinLizara collected 5425 from pot
*** SUMMARY ***
Total pot 5425 | Rake 0 
Board [5d Jc Ac 2d 3d]
Seat 1: Taargeett (button) folded before Flop (didn't bet)
Seat 2: clayjay24 (small blind) folded before Flop
Seat 3: GeoGil233 (big blind) folded before Flop
Seat 4: hchchcvgcggc folded before Flop (didn't bet)
Seat 5: fetis999 folded before Flop (didn't bet)
Seat 6: 70egor70 folded before Flop
Seat 7: Benk_51 folded before Flop (didn't bet)
Seat 8: EdwinLizara showed [Ah Th] and won (5425) with a pair of Aces
Seat 9: nikel51 showed [Kc Qc] and lost with high card Ace



PokerStars Hand #201225964458: Tournament #2620370251, 8700+1300 Hold'em No Limit - Level VIII (150/300) - 2019/06/09 11:43:56 ET
Table '2620370251 32' 9-max Seat #2 is the button
Seat 1: Taargeett (9680 in chips) 
Seat 2: clayjay24 (2330 in chips) 
Seat 3: GeoGil233 (2232 in chips) 
Seat 4: hchchcvgcggc (3220 in chips) 
Seat 5: fetis999 (8908 in chips) 
Seat 6: 70egor70 (6668 in chips) 
Seat 7: Benk_51 (2568 in chips) 
Seat 8: EdwinLizara (5425 in chips) 
Seat 9: nikel51 (4305 in chips) 
Taargeett: posts the ante 25
clayjay24: posts the ante 25
GeoGil233: posts the ante 25
hchchcvgcggc: posts the ante 25
fetis999: posts the ante 25
70egor70: posts the ante 25
Benk_51: posts the ante 25
EdwinLizara: posts the ante 25
nikel51: posts the ante 25
GeoGil233: posts small blind 150
hchchcvgcggc: posts big blind 300
*** HOLE CARDS ***
Dealt to Taargeett [3c 5h]
fetis999: folds 
70egor70: calls 300
Benk_51: calls 300
EdwinLizara: folds 
nikel51: folds 
Taargeett: folds 
clayjay24: folds 
GeoGil233: calls 150
hchchcvgcggc: checks 
*** FLOP *** [2h 6c Th]
GeoGil233: checks 
hchchcvgcggc: checks 
70egor70: bets 300
Benk_51: folds 
GeoGil233: calls 300
hchchcvgcggc: folds 
*** TURN *** [2h 6c Th] [4h]
GeoGil233: bets 300
70egor70: calls 300
*** RIVER *** [2h 6c Th 4h] [7h]
GeoGil233: bets 300
70egor70: calls 300
*** SHOW DOWN ***
GeoGil233: shows [4s Ts] (two pair, Tens and Fours)
70egor70: shows [Jh Ks] (a flush, Jack high)
70egor70 collected 3225 from pot
*** SUMMARY ***
Total pot 3225 | Rake 0 
Board [2h 6c Th 4h 7h]
Seat 1: Taargeett folded before Flop (didn't bet)
Seat 2: clayjay24 (button) folded before Flop (didn't bet)
Seat 3: GeoGil233 (small blind) showed [4s Ts] and lost with two pair, Tens and Fours
Seat 4: hchchcvgcggc (big blind) folded on the Flop
Seat 5: fetis999 folded before Flop (didn't bet)
Seat 6: 70egor70 showed [Jh Ks] and won (3225) with a flush, Jack high
Seat 7: Benk_51 folded on the Flop
Seat 8: EdwinLizara folded before Flop (didn't bet)
Seat 9: nikel51 folded before Flop (didn't bet)



PokerStars Hand #201225993165: Tournament #2620370251, 8700+1300 Hold'em No Limit - Level VIII (150/300) - 2019/06/09 11:44:49 ET
Table '2620370251 32' 9-max Seat #3 is the button
Seat 1: Taargeett (9655 in chips) 
Seat 3: GeoGil233 (1007 in chips) 
Seat 4: hchchcvgcggc (2895 in chips) 
Seat 5: fetis999 (8883 in chips) 
Seat 6: 70egor70 (8668 in chips) 
Seat 7: Benk_51 (2243 in chips) 
Seat 8: EdwinLizara (5400 in chips) 
Seat 9: nikel51 (4280 in chips) 
Taargeett: posts the ante 25
GeoGil233: posts the ante 25
hchchcvgcggc: posts the ante 25
fetis999: posts the ante 25
70egor70: posts the ante 25
Benk_51: posts the ante 25
EdwinLizara: posts the ante 25
nikel51: posts the ante 25
hchchcvgcggc: posts small blind 150
fetis999: posts big blind 300
*** HOLE CARDS ***
Dealt to Taargeett [Ah Td]
70egor70: folds 
Benk_51: folds 
EdwinLizara: calls 300
nikel51: raises 1250 to 1550
Taargeett: folds 
GeoGil233: folds 
hchchcvgcggc: folds 
fetis999: folds 
EdwinLizara: folds 
Uncalled bet (1250) returned to nikel51
nikel51 collected 1250 from pot
nikel51: doesn't show hand 
*** SUMMARY ***
Total pot 1250 | Rake 0 
Seat 1: Taargeett folded before Flop (didn't bet)
Seat 3: GeoGil233 (button) folded before Flop (didn't bet)
Seat 4: hchchcvgcggc (small blind) folded before Flop
Seat 5: fetis999 (big blind) folded before Flop
Seat 6: 70egor70 folded before Flop (didn't bet)
Seat 7: Benk_51 folded before Flop (didn't bet)
Seat 8: EdwinLizara folded before Flop
Seat 9: nikel51 collected (1250)



PokerStars Hand #201226005520: Tournament #2620370251, 8700+1300 Hold'em No Limit - Level IX (200/400) - 2019/06/09 11:45:12 ET
Table '2620370251 32' 9-max Seat #4 is the button
Seat 1: Taargeett (9630 in chips) 
Seat 3: GeoGil233 (982 in chips) 
Seat 4: hchchcvgcggc (2720 in chips) 
Seat 5: fetis999 (8558 in chips) 
Seat 6: 70egor70 (8643 in chips) 
Seat 7: Benk_51 (2218 in chips) 
Seat 8: EdwinLizara (5075 in chips) 
Seat 9: nikel51 (5205 in chips) 
Taargeett: posts the ante 50
GeoGil233: posts the ante 50
hchchcvgcggc: posts the ante 50
fetis999: posts the ante 50
70egor70: posts the ante 50
Benk_51: posts the ante 50
EdwinLizara: posts the ante 50
nikel51: posts the ante 50
fetis999: posts small blind 200
70egor70: posts big blind 400
*** HOLE CARDS ***
Dealt to Taargeett [8h 6d]
Benk_51: folds 
EdwinLizara: folds 
nikel51: calls 400
Taargeett: folds 
GeoGil233: folds 
hchchcvgcggc: raises 2270 to 2670 and is all-in
fetis999: folds 
70egor70: folds 
nikel51: calls 2270
*** FLOP *** [As Ts Ac]
*** TURN *** [As Ts Ac] [3h]
*** RIVER *** [As Ts Ac 3h] [2h]
*** SHOW DOWN ***
nikel51: shows [2s 5s] (two pair, Aces and Deuces)
hchchcvgcggc: shows [Kh 9d] (a pair of Aces)
nikel51 collected 6340 from pot
hchchcvgcggc finished the tournament in 210th place
*** SUMMARY ***
Total pot 6340 | Rake 0 
Board [As Ts Ac 3h 2h]
Seat 1: Taargeett folded before Flop (didn't bet)
Seat 3: GeoGil233 folded before Flop (didn't bet)
Seat 4: hchchcvgcggc (button) showed [Kh 9d] and lost with a pair of Aces
Seat 5: fetis999 (small blind) folded before Flop
Seat 6: 70egor70 (big blind) folded before Flop
Seat 7: Benk_51 folded before Flop (didn't bet)
Seat 8: EdwinLizara folded before Flop (didn't bet)
Seat 9: nikel51 showed [2s 5s] and won (6340) with two pair, Aces and Deuces



PokerStars Hand #201226024977: Tournament #2620370251, 8700+1300 Hold'em No Limit - Level IX (200/400) - 2019/06/09 11:45:48 ET
Table '2620370251 32' 9-max Seat #5 is the button
Seat 1: Taargeett (9580 in chips) 
Seat 2: sl33pyjawn (9695 in chips) 
Seat 3: GeoGil233 (932 in chips) 
Seat 5: fetis999 (8308 in chips) 
Seat 6: 70egor70 (8193 in chips) 
Seat 7: Benk_51 (2168 in chips) 
Seat 8: EdwinLizara (5025 in chips) 
Seat 9: nikel51 (8825 in chips) 
Taargeett: posts the ante 50
sl33pyjawn: posts the ante 50
GeoGil233: posts the ante 50
fetis999: posts the ante 50
70egor70: posts the ante 50
Benk_51: posts the ante 50
EdwinLizara: posts the ante 50
nikel51: posts the ante 50
70egor70: posts small blind 200
Benk_51: posts big blind 400
*** HOLE CARDS ***
Dealt to Taargeett [2s 6s]
EdwinLizara: calls 400
nikel51: folds 
Taargeett: folds 
sl33pyjawn: folds 
GeoGil233: folds 
fetis999 has timed out
fetis999: folds 
70egor70: calls 200
Benk_51: checks 
*** FLOP *** [7s Ah 6c]
70egor70: bets 400
Benk_51: folds 
EdwinLizara: folds 
Uncalled bet (400) returned to 70egor70
70egor70 collected 1600 from pot
70egor70: doesn't show hand 
*** SUMMARY ***
Total pot 1600 | Rake 0 
Board [7s Ah 6c]
Seat 1: Taargeett folded before Flop (didn't bet)
Seat 2: sl33pyjawn folded before Flop (didn't bet)
Seat 3: GeoGil233 folded before Flop (didn't bet)
Seat 5: fetis999 (button) folded before Flop (didn't bet)
Seat 6: 70egor70 (small blind) collected (1600)
Seat 7: Benk_51 (big blind) folded on the Flop
Seat 8: EdwinLizara folded on the Flop
Seat 9: nikel51 folded before Flop (didn't bet)



PokerStars Hand #201226046178: Tournament #2620370251, 8700+1300 Hold'em No Limit - Level IX (200/400) - 2019/06/09 11:46:28 ET
Table '2620370251 32' 9-max Seat #6 is the button
Seat 1: Taargeett (9530 in chips) 
Seat 2: sl33pyjawn (9645 in chips) 
Seat 3: GeoGil233 (882 in chips) 
Seat 4: Fr0s7y (3560 in chips) 
Seat 5: fetis999 (8258 in chips) is sitting out
Seat 6: 70egor70 (9343 in chips) 
Seat 7: Benk_51 (1718 in chips) 
Seat 8: EdwinLizara (4575 in chips) 
Seat 9: nikel51 (8775 in chips) 
Taargeett: posts the ante 50
sl33pyjawn: posts the ante 50
GeoGil233: posts the ante 50
Fr0s7y: posts the ante 50
fetis999: posts the ante 50
70egor70: posts the ante 50
Benk_51: posts the ante 50
EdwinLizara: posts the ante 50
nikel51: posts the ante 50
Benk_51: posts small blind 200
EdwinLizara: posts big blind 400
*** HOLE CARDS ***
Dealt to Taargeett [5s 7c]
nikel51: folds 
Taargeett: folds 
sl33pyjawn: folds 
GeoGil233: folds 
Fr0s7y: folds 
fetis999: folds 
70egor70: calls 400
Benk_51: folds 
EdwinLizara: checks 
*** FLOP *** [8c Qd 6c]
EdwinLizara: bets 400
70egor70: calls 400
*** TURN *** [8c Qd 6c] [Js]
EdwinLizara: bets 400
70egor70: calls 400
*** RIVER *** [8c Qd 6c Js] [8s]
EdwinLizara: bets 400
70egor70: folds 
Uncalled bet (400) returned to EdwinLizara
EdwinLizara collected 3050 from pot
*** SUMMARY ***
Total pot 3050 | Rake 0 
Board [8c Qd 6c Js 8s]
Seat 1: Taargeett folded before Flop (didn't bet)
Seat 2: sl33pyjawn folded before Flop (didn't bet)
Seat 3: GeoGil233 folded before Flop (didn't bet)
Seat 4: Fr0s7y folded before Flop (didn't bet)
Seat 5: fetis999 folded before Flop (didn't bet)
Seat 6: 70egor70 (button) folded on the River
Seat 7: Benk_51 (small blind) folded before Flop
Seat 8: EdwinLizara (big blind) collected (3050)
Seat 9: nikel51 folded before Flop (didn't bet)



PokerStars Hand #201226074828: Tournament #2620370251, 8700+1300 Hold'em No Limit - Level IX (200/400) - 2019/06/09 11:47:21 ET
Table '2620370251 32' 9-max Seat #7 is the button
Seat 1: Taargeett (9480 in chips) 
Seat 2: sl33pyjawn (9595 in chips) 
Seat 3: GeoGil233 (832 in chips) 
Seat 4: Fr0s7y (3510 in chips) 
Seat 5: fetis999 (8208 in chips) is sitting out
Seat 6: 70egor70 (8093 in chips) 
Seat 7: Benk_51 (1468 in chips) 
Seat 8: EdwinLizara (6375 in chips) 
Seat 9: nikel51 (8725 in chips) 
Taargeett: posts the ante 50
sl33pyjawn: posts the ante 50
GeoGil233: posts the ante 50
Fr0s7y: posts the ante 50
fetis999: posts the ante 50
70egor70: posts the ante 50
Benk_51: posts the ante 50
EdwinLizara: posts the ante 50
nikel51: posts the ante 50
EdwinLizara: posts small blind 200
nikel51: posts big blind 400
*** HOLE CARDS ***
Dealt to Taargeett [7d 2c]
Taargeett: folds 
sl33pyjawn: folds 
GeoGil233: folds 
Fr0s7y: folds 
fetis999: folds 
70egor70: folds 
Benk_51: folds 
EdwinLizara: folds 
Uncalled bet (200) returned to nikel51
nikel51 collected 850 from pot
nikel51: doesn't show hand 
*** SUMMARY ***
Total pot 850 | Rake 0 
Seat 1: Taargeett folded before Flop (didn't bet)
Seat 2: sl33pyjawn folded before Flop (didn't bet)
Seat 3: GeoGil233 folded before Flop (didn't bet)
Seat 4: Fr0s7y folded before Flop (didn't bet)
Seat 5: fetis999 folded before Flop (didn't bet)
Seat 6: 70egor70 folded before Flop (didn't bet)
Seat 7: Benk_51 (button) folded before Flop (didn't bet)
Seat 8: EdwinLizara (small blind) folded before Flop
Seat 9: nikel51 (big blind) collected (850)



PokerStars Hand #201226097378: Tournament #2620370251, 8700+1300 Hold'em No Limit - Level IX (200/400) - 2019/06/09 11:48:03 ET
Table '2620370251 32' 9-max Seat #8 is the button
Seat 1: Taargeett (9430 in chips) 
Seat 2: sl33pyjawn (9545 in chips) 
Seat 3: GeoGil233 (782 in chips) 
Seat 4: Fr0s7y (3460 in chips) 
Seat 5: fetis999 (8158 in chips) is sitting out
Seat 6: 70egor70 (8043 in chips) 
Seat 7: Benk_51 (1418 in chips) 
Seat 8: EdwinLizara (6125 in chips) 
Seat 9: nikel51 (9325 in chips) 
Taargeett: posts the ante 50
sl33pyjawn: posts the ante 50
GeoGil233: posts the ante 50
Fr0s7y: posts the ante 50
fetis999: posts the ante 50
70egor70: posts the ante 50
Benk_51: posts the ante 50
EdwinLizara: posts the ante 50
nikel51: posts the ante 50
nikel51: posts small blind 200
Taargeett: posts big blind 400
*** HOLE CARDS ***
Dealt to Taargeett [4d 3h]
sl33pyjawn: folds 
GeoGil233: raises 332 to 732 and is all-in
Fr0s7y: folds 
fetis999: folds 
70egor70: calls 732
Benk_51: folds 
EdwinLizara: folds 
nikel51: calls 532
Taargeett: folds 
*** FLOP *** [Td Ah 9h]
nikel51: checks 
70egor70: bets 400
nikel51: calls 400
*** TURN *** [Td Ah 9h] [Jd]
nikel51: checks 
70egor70: bets 400
nikel51: calls 400
*** RIVER *** [Td Ah 9h Jd] [3s]
nikel51: checks 
70egor70: checks 
*** SHOW DOWN ***
nikel51: shows [6d 8c] (high card Ace)
70egor70: shows [Ac 4s] (a pair of Aces)
70egor70 collected 1600 from side pot
GeoGil233: shows [Kc Qd] (a straight, Ten to Ace)
GeoGil233 collected 3046 from main pot
*** SUMMARY ***
Total pot 4646 Main pot 3046. Side pot 1600. | Rake 0 
Board [Td Ah 9h Jd 3s]
Seat 1: Taargeett (big blind) folded before Flop
Seat 2: sl33pyjawn folded before Flop (didn't bet)
Seat 3: GeoGil233 showed [Kc Qd] and won (3046) with a straight, Ten to Ace
Seat 4: Fr0s7y folded before Flop (didn't bet)
Seat 5: fetis999 folded before Flop (didn't bet)
Seat 6: 70egor70 showed [Ac 4s] and won (1600) with a pair of Aces
Seat 7: Benk_51 folded before Flop (didn't bet)
Seat 8: EdwinLizara (button) folded before Flop (didn't bet)
Seat 9: nikel51 (small blind) showed [6d 8c] and lost with high card Ace



PokerStars Hand #201226139819: Tournament #2620370251, 8700+1300 Hold'em No Limit - Level IX (200/400) - 2019/06/09 11:49:12 ET
Table '2620370251 32' 9-max Seat #9 is the button
Seat 1: Taargeett (8980 in chips) 
Seat 2: sl33pyjawn (9495 in chips) 
Seat 3: GeoGil233 (3046 in chips) 
Seat 4: Fr0s7y (3410 in chips) 
Seat 5: fetis999 (8108 in chips) is sitting out
Seat 6: 70egor70 (8061 in chips) 
Seat 7: Benk_51 (1368 in chips) 
Seat 8: EdwinLizara (6075 in chips) 
Seat 9: nikel51 (7743 in chips) 
Taargeett: posts the ante 50
sl33pyjawn: posts the ante 50
GeoGil233: posts the ante 50
Fr0s7y: posts the ante 50
fetis999: posts the ante 50
70egor70: posts the ante 50
Benk_51: posts the ante 50
EdwinLizara: posts the ante 50
nikel51: posts the ante 50
Taargeett: posts small blind 200
sl33pyjawn: posts big blind 400
*** HOLE CARDS ***
Dealt to Taargeett [7c Ts]
GeoGil233: folds 
Fr0s7y: calls 400
fetis999: folds 
70egor70: calls 400
Benk_51: folds 
EdwinLizara: calls 400
nikel51: folds 
Taargeett: folds 
sl33pyjawn: checks 
*** FLOP *** [Ad 6s Tc]
sl33pyjawn: checks 
Fr0s7y: checks 
70egor70: bets 1200
EdwinLizara: folds 
sl33pyjawn: folds 
Fr0s7y: folds 
Uncalled bet (1200) returned to 70egor70
70egor70 collected 2250 from pot
70egor70: doesn't show hand 
*** SUMMARY ***
Total pot 2250 | Rake 0 
Board [Ad 6s Tc]
Seat 1: Taargeett (small blind) folded before Flop
Seat 2: sl33pyjawn (big blind) folded on the Flop
Seat 3: GeoGil233 folded before Flop (didn't bet)
Seat 4: Fr0s7y folded on the Flop
Seat 5: fetis999 folded before Flop (didn't bet)
Seat 6: 70egor70 collected (2250)
Seat 7: Benk_51 folded before Flop (didn't bet)
Seat 8: EdwinLizara folded on the Flop
Seat 9: nikel51 (button) folded before Flop (didn't bet)



PokerStars Hand #201226183336: Tournament #2620370251, 8700+1300 Hold'em No Limit - Level X (300/600) - 2019/06/09 11:50:33 ET
Table '2620370251 32' 9-max Seat #1 is the button
Seat 1: Taargeett (8730 in chips) 
Seat 2: sl33pyjawn (9045 in chips) 
Seat 3: GeoGil233 (2996 in chips) 
Seat 4: Fr0s7y (2960 in chips) 
Seat 5: fetis999 (8058 in chips) is sitting out
Seat 6: 70egor70 (9861 in chips) 
Seat 7: Benk_51 (1318 in chips) 
Seat 8: EdwinLizara (5625 in chips) 
Seat 9: nikel51 (7693 in chips) 
Taargeett: posts the ante 50
sl33pyjawn: posts the ante 50
GeoGil233: posts the ante 50
Fr0s7y: posts the ante 50
fetis999: posts the ante 50
70egor70: posts the ante 50
Benk_51: posts the ante 50
EdwinLizara: posts the ante 50
nikel51: posts the ante 50
sl33pyjawn: posts small blind 300
GeoGil233: posts big blind 600
*** HOLE CARDS ***
Dealt to Taargeett [Th 9s]
Fr0s7y: calls 600
fetis999: folds 
70egor70: calls 600
Benk_51: folds 
EdwinLizara: calls 600
nikel51: calls 600
Taargeett: folds 
sl33pyjawn: folds 
GeoGil233: checks 
*** FLOP *** [9c 8c Jh]
GeoGil233: checks 
Fr0s7y: checks 
70egor70: bets 1200
EdwinLizara: folds 
nikel51: calls 1200
GeoGil233: folds 
Fr0s7y: calls 1200
*** TURN *** [9c 8c Jh] [3s]
Fr0s7y: checks 
70egor70: checks 
nikel51: checks 
*** RIVER *** [9c 8c Jh 3s] [4s]
Fr0s7y: checks 
70egor70: bets 600
nikel51: folds 
Fr0s7y: folds 
Uncalled bet (600) returned to 70egor70
70egor70 collected 7350 from pot
70egor70: doesn't show hand 
*** SUMMARY ***
Total pot 7350 | Rake 0 
Board [9c 8c Jh 3s 4s]
Seat 1: Taargeett (button) folded before Flop (didn't bet)
Seat 2: sl33pyjawn (small blind) folded before Flop
Seat 3: GeoGil233 (big blind) folded on the Flop
Seat 4: Fr0s7y folded on the River
Seat 5: fetis999 folded before Flop (didn't bet)
Seat 6: 70egor70 collected (7350)
Seat 7: Benk_51 folded before Flop (didn't bet)
Seat 8: EdwinLizara folded on the Flop
Seat 9: nikel51 folded on the River



PokerStars Hand #201226215843: Tournament #2620370251, 8700+1300 Hold'em No Limit - Level X (300/600) - 2019/06/09 11:51:34 ET
Table '2620370251 32' 9-max Seat #2 is the button
Seat 1: Taargeett (8680 in chips) 
Seat 2: sl33pyjawn (8695 in chips) 
Seat 3: GeoGil233 (2346 in chips) 
Seat 4: Fr0s7y (1110 in chips) 
Seat 5: fetis999 (8008 in chips) is sitting out
Seat 6: 70egor70 (15361 in chips) 
Seat 7: Benk_51 (1268 in chips) 
Seat 8: EdwinLizara (4975 in chips) 
Seat 9: nikel51 (5843 in chips) 
Taargeett: posts the ante 50
sl33pyjawn: posts the ante 50
GeoGil233: posts the ante 50
Fr0s7y: posts the ante 50
fetis999: posts the ante 50
70egor70: posts the ante 50
Benk_51: posts the ante 50
EdwinLizara: posts the ante 50
nikel51: posts the ante 50
GeoGil233: posts small blind 300
Fr0s7y: posts big blind 600
*** HOLE CARDS ***
Dealt to Taargeett [8c 9c]
fetis999: folds 
70egor70: calls 600
Benk_51: raises 618 to 1218 and is all-in
EdwinLizara: folds 
nikel51: calls 1218
Taargeett: folds 
sl33pyjawn: folds 
GeoGil233: folds 
Fr0s7y: calls 460 and is all-in
70egor70: calls 618
*** FLOP *** [3c Qs Td]
70egor70: bets 600
nikel51: raises 600 to 1200
70egor70: calls 600
*** TURN *** [3c Qs Td] [3d]
70egor70: bets 1800
nikel51: raises 1575 to 3375 and is all-in
70egor70: calls 1575
*** RIVER *** [3c Qs Td 3d] [4c]
*** SHOW DOWN ***
70egor70: shows [Ks 3s] (three of a kind, Threes)
nikel51: shows [Kc Kh] (two pair, Kings and Threes)
70egor70 collected 9150 from side pot-2 
Benk_51: shows [7c 7d] (two pair, Sevens and Threes)
70egor70 collected 474 from side pot-1 
Fr0s7y: shows [7s 9s] (a pair of Threes)
70egor70 collected 4990 from main pot
nikel51 finished the tournament in 144th place and received 10500.
Benk_51 finished the tournament in 145th place and received 10200.
Fr0s7y finished the tournament in 146th place and received 10200.
*** SUMMARY ***
Total pot 14614 Main pot 4990. Side pot-1 474. Side pot-2 9150. | Rake 0 
Board [3c Qs Td 3d 4c]
Seat 1: Taargeett folded before Flop (didn't bet)
Seat 2: sl33pyjawn (button) folded before Flop (didn't bet)
Seat 3: GeoGil233 (small blind) folded before Flop
Seat 4: Fr0s7y (big blind) showed [7s 9s] and lost with a pair of Threes
Seat 5: fetis999 folded before Flop (didn't bet)
Seat 6: 70egor70 showed [Ks 3s] and won (14614) with three of a kind, Threes
Seat 7: Benk_51 showed [7c 7d] and lost with two pair, Sevens and Threes
Seat 8: EdwinLizara folded before Flop (didn't bet)
Seat 9: nikel51 showed [Kc Kh] and lost with two pair, Kings and Threes



PokerStars Hand #201226258402: Tournament #2620370251, 8700+1300 Hold'em No Limit - Level X (300/600) - 2019/06/09 11:52:53 ET
Table '2620370251 27' 9-max Seat #7 is the button
Seat 1: papylapeche (1625 in chips) 
Seat 2: CyberArs (16093 in chips) 
Seat 3: MaverickSalva (6100 in chips) 
Seat 4: PlayMCp (2335 in chips) 
Seat 5: Taargeett (8630 in chips) 
Seat 6: carlos676754 (5835 in chips) 
Seat 7: danonxrapboy (3970 in chips) 
Seat 8: lokut552 (1480 in chips) 
Seat 9: polaco43 (14425 in chips) 
papylapeche: posts the ante 50
CyberArs: posts the ante 50
MaverickSalva: posts the ante 50
PlayMCp: posts the ante 50
Taargeett: posts the ante 50
carlos676754: posts the ante 50
danonxrapboy: posts the ante 50
lokut552: posts the ante 50
polaco43: posts the ante 50
lokut552: posts small blind 300
polaco43: posts big blind 600
*** HOLE CARDS ***
Dealt to Taargeett [8d As]
papylapeche: folds 
CyberArs: folds 
MaverickSalva: folds 
PlayMCp: folds 
Taargeett: raises 600 to 1200
carlos676754: folds 
danonxrapboy: calls 1200
lokut552: calls 900
polaco43: calls 600
*** FLOP *** [6h Ks 2d]
lokut552: bets 230 and is all-in
polaco43: raises 3370 to 3600
Taargeett: folds 
danonxrapboy: calls 2720 and is all-in
Uncalled bet (880) returned to polaco43
*** TURN *** [6h Ks 2d] [7d]
*** RIVER *** [6h Ks 2d 7d] [4c]
*** SHOW DOWN ***
polaco43: shows [6s 2s] (two pair, Sixes and Deuces)
danonxrapboy: shows [Jd Kd] (a pair of Kings)
polaco43 collected 4980 from side pot
lokut552: shows [6c Qc] (a pair of Sixes)
polaco43 collected 5940 from main pot
danonxrapboy finished the tournament in 134th place and received 11200.
lokut552 finished the tournament in 135th place and received 11200.
*** SUMMARY ***
Total pot 10920 Main pot 5940. Side pot 4980. | Rake 0 
Board [6h Ks 2d 7d 4c]
Seat 1: papylapeche folded before Flop (didn't bet)
Seat 2: CyberArs folded before Flop (didn't bet)
Seat 3: MaverickSalva folded before Flop (didn't bet)
Seat 4: PlayMCp folded before Flop (didn't bet)
Seat 5: Taargeett folded on the Flop
Seat 6: carlos676754 folded before Flop (didn't bet)
Seat 7: danonxrapboy (button) showed [Jd Kd] and lost with a pair of Kings
Seat 8: lokut552 (small blind) showed [6c Qc] and lost with a pair of Sixes
Seat 9: polaco43 (big blind) showed [6s 2s] and won (10920) with two pair, Sixes and Deuces



PokerStars Hand #201226289907: Tournament #2620370251, 8700+1300 Hold'em No Limit - Level X (300/600) - 2019/06/09 11:53:52 ET
Table '2620370251 27' 9-max Seat #9 is the button
Seat 1: papylapeche (1575 in chips) 
Seat 2: CyberArs (16043 in chips) 
Seat 3: MaverickSalva (6050 in chips) 
Seat 4: PlayMCp (2285 in chips) 
Seat 5: Taargeett (7380 in chips) 
Seat 6: carlos676754 (5785 in chips) 
Seat 8: qzh777 (1632 in chips) 
Seat 9: polaco43 (21375 in chips) 
papylapeche: posts the ante 50
CyberArs: posts the ante 50
MaverickSalva: posts the ante 50
PlayMCp: posts the ante 50
Taargeett: posts the ante 50
carlos676754: posts the ante 50
qzh777: posts the ante 50
polaco43: posts the ante 50
papylapeche: posts small blind 300
CyberArs: posts big blind 600
*** HOLE CARDS ***
Dealt to Taargeett [As Ah]
MaverickSalva: calls 600
PlayMCp: folds 
Taargeett: raises 600 to 1200
carlos676754: folds 
qzh777: folds 
polaco43: folds 
papylapeche: folds 
CyberArs: calls 600
MaverickSalva: calls 600
*** FLOP *** [Qd 5c 8h]
CyberArs: checks 
MaverickSalva: bets 2150
Taargeett: raises 2150 to 4300
CyberArs: folds 
MaverickSalva: raises 500 to 4800 and is all-in
Taargeett: calls 500
*** TURN *** [Qd 5c 8h] [Jd]
*** RIVER *** [Qd 5c 8h Jd] [5s]
*** SHOW DOWN ***
MaverickSalva: shows [Qc 8c] (two pair, Queens and Eights)
Taargeett: shows [As Ah] (two pair, Aces and Fives)
Taargeett collected 13900 from pot
MaverickSalva finished the tournament in 123rd place and received 11900.
*** SUMMARY ***
Total pot 13900 | Rake 0 
Board [Qd 5c 8h Jd 5s]
Seat 1: papylapeche (small blind) folded before Flop
Seat 2: CyberArs (big blind) folded on the Flop
Seat 3: MaverickSalva showed [Qc 8c] and lost with two pair, Queens and Eights
Seat 4: PlayMCp folded before Flop (didn't bet)
Seat 5: Taargeett showed [As Ah] and won (13900) with two pair, Aces and Fives
Seat 6: carlos676754 folded before Flop (didn't bet)
Seat 8: qzh777 folded before Flop (didn't bet)
Seat 9: polaco43 (button) folded before Flop (didn't bet)



PokerStars Hand #201226313245: Tournament #2620370251, 8700+1300 Hold'em No Limit - Level X (300/600) - 2019/06/09 11:54:35 ET
Table '2620370251 27' 9-max Seat #1 is the button
Seat 1: papylapeche (1225 in chips) 
Seat 2: CyberArs (14793 in chips) 
Seat 4: PlayMCp (2235 in chips) 
Seat 5: Taargeett (15230 in chips) 
Seat 6: carlos676754 (5735 in chips) 
Seat 7: swissrabbit09 (8024 in chips) 
Seat 8: qzh777 (1582 in chips) 
Seat 9: polaco43 (21325 in chips) 
papylapeche: posts the ante 50
CyberArs: posts the ante 50
PlayMCp: posts the ante 50
Taargeett: posts the ante 50
carlos676754: posts the ante 50
swissrabbit09: posts the ante 50
qzh777: posts the ante 50
polaco43: posts the ante 50
CyberArs: posts small blind 300
PlayMCp: posts big blind 600
*** HOLE CARDS ***
Dealt to Taargeett [7h Ad]
Taargeett: folds 
carlos676754: folds 
swissrabbit09: raises 600 to 1200
qzh777: folds 
polaco43: folds 
papylapeche: folds 
CyberArs: calls 900
PlayMCp: calls 600
*** FLOP *** [Qs 8s 3d]
CyberArs: checks 
PlayMCp: checks 
swissrabbit09: bets 600
CyberArs: calls 600
PlayMCp: folds 
*** TURN *** [Qs 8s 3d] [8d]
CyberArs: checks 
swissrabbit09: checks 
*** RIVER *** [Qs 8s 3d 8d] [6d]
CyberArs: checks 
swissrabbit09: checks 
*** SHOW DOWN ***
CyberArs: shows [2c Ac] (a pair of Eights)
swissrabbit09: shows [9s As] (a pair of Eights - Ace+Queen+Nine kicker)
swissrabbit09 collected 5200 from pot
*** SUMMARY ***
Total pot 5200 | Rake 0 
Board [Qs 8s 3d 8d 6d]
Seat 1: papylapeche (button) folded before Flop (didn't bet)
Seat 2: CyberArs (small blind) showed [2c Ac] and lost with a pair of Eights
Seat 4: PlayMCp (big blind) folded on the Flop
Seat 5: Taargeett folded before Flop (didn't bet)
Seat 6: carlos676754 folded before Flop (didn't bet)
Seat 7: swissrabbit09 showed [9s As] and won (5200) with a pair of Eights
Seat 8: qzh777 folded before Flop (didn't bet)
Seat 9: polaco43 folded before Flop (didn't bet)



PokerStars Hand #201226497484: Tournament #2620370251, 8700+1300 Hold'em No Limit - Level XI (400/800) - 2019/06/09 12:01:57 ET
Table '2620370251 27' 9-max Seat #2 is the button
Seat 1: papylapeche (1175 in chips) 
Seat 2: CyberArs (12943 in chips) 
Seat 3: Rayvas (5761 in chips) out of hand (moved from another table into small blind)
Seat 4: PlayMCp (985 in chips) 
Seat 5: Taargeett (15180 in chips) 
Seat 6: carlos676754 (5685 in chips) 
Seat 7: swissrabbit09 (11374 in chips) 
Seat 8: qzh777 (1532 in chips) 
Seat 9: polaco43 (21275 in chips) 
Rayvas will be allowed to play after the button
papylapeche: posts the ante 75
CyberArs: posts the ante 75
PlayMCp: posts the ante 75
Taargeett: posts the ante 75
carlos676754: posts the ante 75
swissrabbit09: posts the ante 75
qzh777: posts the ante 75
polaco43: posts the ante 75
PlayMCp: posts small blind 400
Taargeett: posts big blind 800
*** HOLE CARDS ***
Dealt to Taargeett [Kd 8h]
carlos676754 has timed out
carlos676754: folds 
swissrabbit09: folds 
qzh777: raises 657 to 1457 and is all-in
polaco43: folds 
papylapeche: folds 
CyberArs: folds 
PlayMCp: calls 510 and is all-in
Taargeett: calls 657
*** FLOP *** [3c 5c 7d]
*** TURN *** [3c 5c 7d] [6c]
*** RIVER *** [3c 5c 7d 6c] [Jh]
*** SHOW DOWN ***
Taargeett: shows [Kd 8h] (high card King)
qzh777: shows [6s 9s] (a pair of Sixes)
qzh777 collected 1094 from side pot
PlayMCp: shows [Kc Jc] (a flush, King high)
PlayMCp collected 3330 from main pot
*** SUMMARY ***
Total pot 4424 Main pot 3330. Side pot 1094. | Rake 0 
Board [3c 5c 7d 6c Jh]
Seat 1: papylapeche folded before Flop (didn't bet)
Seat 2: CyberArs (button) folded before Flop (didn't bet)
Seat 4: PlayMCp (small blind) showed [Kc Jc] and won (3330) with a flush, King high
Seat 5: Taargeett (big blind) showed [Kd 8h] and lost with high card King
Seat 6: carlos676754 folded before Flop (didn't bet)
Seat 7: swissrabbit09 folded before Flop (didn't bet)
Seat 8: qzh777 showed [6s 9s] and won (1094) with a pair of Sixes
Seat 9: polaco43 folded before Flop (didn't bet)



PokerStars Hand #201226526094: Tournament #2620370251, 8700+1300 Hold'em No Limit - Level XI (400/800) - 2019/06/09 12:02:52 ET
Table '2620370251 27' 9-max Seat #4 is the button
Seat 1: papylapeche (1100 in chips) 
Seat 2: CyberArs (12868 in chips) 
Seat 3: Rayvas (5761 in chips) 
Seat 4: PlayMCp (3330 in chips) 
Seat 5: Taargeett (13648 in chips) 
Seat 6: carlos676754 (5610 in chips) 
Seat 7: swissrabbit09 (11299 in chips) 
Seat 8: qzh777 (1094 in chips) 
Seat 9: polaco43 (21200 in chips) 
papylapeche: posts the ante 75
CyberArs: posts the ante 75
Rayvas: posts the ante 75
PlayMCp: posts the ante 75
Taargeett: posts the ante 75
carlos676754: posts the ante 75
swissrabbit09: posts the ante 75
qzh777: posts the ante 75
polaco43: posts the ante 75
Taargeett: posts small blind 400
carlos676754: posts big blind 800
*** HOLE CARDS ***
Dealt to Taargeett [Ad 4s]
swissrabbit09: folds 
qzh777: raises 219 to 1019 and is all-in
polaco43: folds 
papylapeche: folds 
CyberArs: folds 
Rayvas: folds 
PlayMCp: raises 2236 to 3255 and is all-in
Taargeett: folds 
carlos676754: calls 2455
*** FLOP *** [3c Js Ks]
*** TURN *** [3c Js Ks] [6c]
*** RIVER *** [3c Js Ks 6c] [Jc]
*** SHOW DOWN ***
carlos676754: shows [Kc Jd] (a full house, Jacks full of Kings)
PlayMCp: shows [Ah Kh] (two pair, Kings and Jacks)
carlos676754 collected 4472 from side pot
qzh777: shows [As 2d] (a pair of Jacks)
carlos676754 collected 4132 from main pot
PlayMCp finished the tournament in 111th place and received 12700.
qzh777 finished the tournament in 112th place and received 12700.
*** SUMMARY ***
Total pot 8604 Main pot 4132. Side pot 4472. | Rake 0 
Board [3c Js Ks 6c Jc]
Seat 1: papylapeche folded before Flop (didn't bet)
Seat 2: CyberArs folded before Flop (didn't bet)
Seat 3: Rayvas folded before Flop (didn't bet)
Seat 4: PlayMCp (button) showed [Ah Kh] and lost with two pair, Kings and Jacks
Seat 5: Taargeett (small blind) folded before Flop
Seat 6: carlos676754 (big blind) showed [Kc Jd] and won (8604) with a full house, Jacks full of Kings
Seat 7: swissrabbit09 folded before Flop (didn't bet)
Seat 8: qzh777 showed [As 2d] and lost with a pair of Jacks
Seat 9: polaco43 folded before Flop (didn't bet)



PokerStars Hand #201226547915: Tournament #2620370251, 8700+1300 Hold'em No Limit - Level XI (400/800) - 2019/06/09 12:03:32 ET
Table '2620370251 27' 9-max Seat #5 is the button
Seat 1: papylapeche (1025 in chips) 
Seat 2: CyberArs (12793 in chips) 
Seat 3: Rayvas (5686 in chips) 
Seat 5: Taargeett (13173 in chips) 
Seat 6: carlos676754 (10884 in chips) 
Seat 7: swissrabbit09 (11224 in chips) 
Seat 8: bdpokrface65 (1820 in chips) 
Seat 9: polaco43 (21125 in chips) 
papylapeche: posts the ante 75
CyberArs: posts the ante 75
Rayvas: posts the ante 75
Taargeett: posts the ante 75
carlos676754: posts the ante 75
swissrabbit09: posts the ante 75
bdpokrface65: posts the ante 75
polaco43: posts the ante 75
carlos676754: posts small blind 400
swissrabbit09: posts big blind 800
*** HOLE CARDS ***
Dealt to Taargeett [Jh 5h]
bdpokrface65: raises 945 to 1745 and is all-in
polaco43: folds 
papylapeche: folds 
CyberArs: folds 
Rayvas: folds 
Taargeett: folds 
carlos676754: folds 
swissrabbit09: folds 
Uncalled bet (945) returned to bdpokrface65
bdpokrface65 collected 2600 from pot
*** SUMMARY ***
Total pot 2600 | Rake 0 
Seat 1: papylapeche folded before Flop (didn't bet)
Seat 2: CyberArs folded before Flop (didn't bet)
Seat 3: Rayvas folded before Flop (didn't bet)
Seat 5: Taargeett (button) folded before Flop (didn't bet)
Seat 6: carlos676754 (small blind) folded before Flop
Seat 7: swissrabbit09 (big blind) folded before Flop
Seat 8: bdpokrface65 collected (2600)
Seat 9: polaco43 folded before Flop (didn't bet)



PokerStars Hand #201226566213: Tournament #2620370251, 8700+1300 Hold'em No Limit - Level XI (400/800) - 2019/06/09 12:04:06 ET
Table '2620370251 27' 9-max Seat #6 is the button
Seat 1: papylapeche (950 in chips) 
Seat 2: CyberArs (12718 in chips) 
Seat 3: Rayvas (5611 in chips) 
Seat 5: Taargeett (13098 in chips) 
Seat 6: carlos676754 (10409 in chips) 
Seat 7: swissrabbit09 (10349 in chips) 
Seat 8: bdpokrface65 (3545 in chips) 
Seat 9: polaco43 (21050 in chips) 
papylapeche: posts the ante 75
CyberArs: posts the ante 75
Rayvas: posts the ante 75
Taargeett: posts the ante 75
carlos676754: posts the ante 75
swissrabbit09: posts the ante 75
bdpokrface65: posts the ante 75
polaco43: posts the ante 75
swissrabbit09: posts small blind 400
bdpokrface65: posts big blind 800
*** HOLE CARDS ***
Dealt to Taargeett [5s Ac]
polaco43: calls 800
papylapeche: folds 
CyberArs: calls 800
Rayvas: calls 800
Taargeett: folds 
carlos676754: folds 
swissrabbit09: folds 
bdpokrface65: raises 2670 to 3470 and is all-in
polaco43: calls 2670
CyberArs: folds 
Rayvas: calls 2670
*** FLOP *** [6h Jh 3d]
polaco43: checks 
Rayvas: checks 
*** TURN *** [6h Jh 3d] [As]
polaco43: checks 
Rayvas: bets 2066 and is all-in
polaco43: folds 
Uncalled bet (2066) returned to Rayvas
*** RIVER *** [6h Jh 3d As] [Tc]
*** SHOW DOWN ***
bdpokrface65: shows [9s 9h] (a pair of Nines)
Rayvas: shows [Qh Ah] (a pair of Aces)
Rayvas collected 12210 from pot
bdpokrface65 finished the tournament in 104th place and received 13400.
*** SUMMARY ***
Total pot 12210 | Rake 0 
Board [6h Jh 3d As Tc]
Seat 1: papylapeche folded before Flop (didn't bet)
Seat 2: CyberArs folded before Flop
Seat 3: Rayvas showed [Qh Ah] and won (12210) with a pair of Aces
Seat 5: Taargeett folded before Flop (didn't bet)
Seat 6: carlos676754 (button) folded before Flop (didn't bet)
Seat 7: swissrabbit09 (small blind) folded before Flop
Seat 8: bdpokrface65 (big blind) showed [9s 9h] and lost with a pair of Nines
Seat 9: polaco43 folded on the Turn



PokerStars Hand #201226598936: Tournament #2620370251, 8700+1300 Hold'em No Limit - Level XI (400/800) - 2019/06/09 12:05:06 ET
Table '2620370251 27' 9-max Seat #7 is the button
Seat 1: papylapeche (875 in chips) 
Seat 2: CyberArs (11843 in chips) 
Seat 3: Rayvas (14276 in chips) 
Seat 4: gemmerik (20533 in chips) 
Seat 5: Taargeett (13023 in chips) 
Seat 6: carlos676754 (10334 in chips) 
Seat 7: swissrabbit09 (9874 in chips) 
Seat 9: polaco43 (17505 in chips) 
papylapeche: posts the ante 75
CyberArs: posts the ante 75
Rayvas: posts the ante 75
gemmerik: posts the ante 75
Taargeett: posts the ante 75
carlos676754: posts the ante 75
swissrabbit09: posts the ante 75
polaco43: posts the ante 75
polaco43: posts small blind 400
papylapeche: posts big blind 800 and is all-in
*** HOLE CARDS ***
Dealt to Taargeett [Tc 7s]
CyberArs: calls 800
Rayvas: folds 
gemmerik: calls 800
Taargeett: folds 
carlos676754: calls 800
swissrabbit09: folds 
polaco43: folds 
*** FLOP *** [Jd 6s 2c]
CyberArs: checks 
gemmerik: checks 
carlos676754: checks 
*** TURN *** [Jd 6s 2c] [Qc]
CyberArs: bets 800
gemmerik: calls 800
carlos676754: calls 800
*** RIVER *** [Jd 6s 2c Qc] [Jh]
CyberArs: bets 6600
gemmerik: folds 
carlos676754: folds 
Uncalled bet (6600) returned to CyberArs
*** SHOW DOWN ***
CyberArs: shows [5c Jc] (three of a kind, Jacks)
CyberArs collected 2400 from side pot
papylapeche: shows [Qs 4d] (two pair, Queens and Jacks)
CyberArs collected 4200 from main pot
papylapeche finished the tournament in 101st place and received 13400.
*** SUMMARY ***
Total pot 6600 Main pot 4200. Side pot 2400. | Rake 0 
Board [Jd 6s 2c Qc Jh]
Seat 1: papylapeche (big blind) showed [Qs 4d] and lost with two pair, Queens and Jacks
Seat 2: CyberArs showed [5c Jc] and won (6600) with three of a kind, Jacks
Seat 3: Rayvas folded before Flop (didn't bet)
Seat 4: gemmerik folded on the River
Seat 5: Taargeett folded before Flop (didn't bet)
Seat 6: carlos676754 folded on the River
Seat 7: swissrabbit09 (button) folded before Flop (didn't bet)
Seat 9: polaco43 (small blind) folded before Flop



PokerStars Hand #201226623377: Tournament #2620370251, 8700+1300 Hold'em No Limit - Level XI (400/800) - 2019/06/09 12:05:50 ET
Table '2620370251 27' 9-max Seat #9 is the button
Seat 2: CyberArs (16768 in chips) 
Seat 3: Rayvas (14201 in chips) 
Seat 4: gemmerik (18858 in chips) 
Seat 5: Taargeett (12948 in chips) 
Seat 6: carlos676754 (8659 in chips) 
Seat 7: swissrabbit09 (9799 in chips) 
Seat 9: polaco43 (17030 in chips) 
CyberArs: posts the ante 75
Rayvas: posts the ante 75
gemmerik: posts the ante 75
Taargeett: posts the ante 75
carlos676754: posts the ante 75
swissrabbit09: posts the ante 75
polaco43: posts the ante 75
CyberArs: posts small blind 400
Rayvas: posts big blind 800
*** HOLE CARDS ***
Dealt to Taargeett [9s 2s]
gemmerik: folds 
Taargeett: folds 
carlos676754: folds 
swissrabbit09: calls 800
polaco43: folds 
CyberArs: calls 400
Rayvas: checks 
*** FLOP *** [Th 2h Td]
CyberArs: checks 
Rayvas: checks 
swissrabbit09: checks 
*** TURN *** [Th 2h Td] [Qs]
CyberArs: bets 800
Rayvas: folds 
swissrabbit09: raises 800 to 1600
CyberArs: calls 800
*** RIVER *** [Th 2h Td Qs] [7s]
CyberArs: bets 800
swissrabbit09: calls 800
*** SHOW DOWN ***
CyberArs: shows [Ks Qh] (two pair, Queens and Tens)
swissrabbit09: mucks hand 
CyberArs collected 7725 from pot
*** SUMMARY ***
Total pot 7725 | Rake 0 
Board [Th 2h Td Qs 7s]
Seat 2: CyberArs (small blind) showed [Ks Qh] and won (7725) with two pair, Queens and Tens
Seat 3: Rayvas (big blind) folded on the Turn
Seat 4: gemmerik folded before Flop (didn't bet)
Seat 5: Taargeett folded before Flop (didn't bet)
Seat 6: carlos676754 folded before Flop (didn't bet)
Seat 7: swissrabbit09 mucked [Qc Jd]
Seat 9: polaco43 (button) folded before Flop (didn't bet)



PokerStars Hand #201226651020: Tournament #2620370251, 8700+1300 Hold'em No Limit - Level XI (400/800) - 2019/06/09 12:06:41 ET
Table '2620370251 27' 9-max Seat #2 is the button
Seat 1: fetis999 (5358 in chips) is sitting out
Seat 2: CyberArs (21218 in chips) 
Seat 3: Rayvas (13326 in chips) 
Seat 4: gemmerik (18783 in chips) 
Seat 5: Taargeett (12873 in chips) 
Seat 6: carlos676754 (8584 in chips) 
Seat 7: swissrabbit09 (6524 in chips) 
Seat 8: francosil (6450 in chips) is sitting out
Seat 9: polaco43 (16955 in chips) 
fetis999: posts the ante 75
CyberArs: posts the ante 75
Rayvas: posts the ante 75
gemmerik: posts the ante 75
Taargeett: posts the ante 75
carlos676754: posts the ante 75
swissrabbit09: posts the ante 75
francosil: posts the ante 75
polaco43: posts the ante 75
Rayvas: posts small blind 400
gemmerik: posts big blind 800
*** HOLE CARDS ***
Dealt to Taargeett [3c 6c]
Taargeett: folds 
carlos676754: calls 800
swissrabbit09: folds 
francosil: folds 
polaco43: folds 
fetis999: folds 
CyberArs: calls 800
Rayvas: folds 
gemmerik: checks 
*** FLOP *** [Ac Qc 8h]
gemmerik: checks 
carlos676754: checks 
CyberArs: bets 1738
gemmerik: folds 
carlos676754: calls 1738
*** TURN *** [Ac Qc 8h] [Ks]
carlos676754: checks 
francosil is disconnected 
CyberArs: bets 3476
carlos676754: calls 3476
*** RIVER *** [Ac Qc 8h Ks] [2c]
carlos676754: checks 
CyberArs: checks 
*** SHOW DOWN ***
carlos676754: shows [Kd Ts] (a pair of Kings)
CyberArs: shows [Ah 8s] (two pair, Aces and Eights)
CyberArs collected 13903 from pot
*** SUMMARY ***
Total pot 13903 | Rake 0 
Board [Ac Qc 8h Ks 2c]
Seat 1: fetis999 folded before Flop (didn't bet)
Seat 2: CyberArs (button) showed [Ah 8s] and won (13903) with two pair, Aces and Eights
Seat 3: Rayvas (small blind) folded before Flop
Seat 4: gemmerik (big blind) folded on the Flop
Seat 5: Taargeett folded before Flop (didn't bet)
Seat 6: carlos676754 showed [Kd Ts] and lost with a pair of Kings
Seat 7: swissrabbit09 folded before Flop (didn't bet)
Seat 8: francosil folded before Flop (didn't bet)
Seat 9: polaco43 folded before Flop (didn't bet)



PokerStars Hand #201226682461: Tournament #2620370251, 8700+1300 Hold'em No Limit - Level XII (500/1000) - 2019/06/09 12:07:38 ET
Table '2620370251 27' 9-max Seat #3 is the button
Seat 1: fetis999 (5283 in chips) is sitting out
Seat 2: CyberArs (29032 in chips) 
Seat 3: Rayvas (12851 in chips) 
Seat 4: gemmerik (17908 in chips) 
Seat 5: Taargeett (12798 in chips) 
Seat 6: carlos676754 (2495 in chips) 
Seat 7: swissrabbit09 (6449 in chips) 
Seat 8: francosil (6375 in chips) is sitting out
Seat 9: polaco43 (16880 in chips) 
fetis999: posts the ante 100
CyberArs: posts the ante 100
Rayvas: posts the ante 100
gemmerik: posts the ante 100
Taargeett: posts the ante 100
carlos676754: posts the ante 100
swissrabbit09: posts the ante 100
francosil: posts the ante 100
polaco43: posts the ante 100
gemmerik: posts small blind 500
Taargeett: posts big blind 1000
*** HOLE CARDS ***
Dealt to Taargeett [Kd Qh]
carlos676754: calls 1000
swissrabbit09: raises 1000 to 2000
francosil: folds 
polaco43: folds 
fetis999: folds 
CyberArs: folds 
Rayvas: folds 
gemmerik: calls 1500
Taargeett: raises 2000 to 4000
carlos676754: calls 1395 and is all-in
swissrabbit09: raises 2349 to 6349 and is all-in
gemmerik: calls 4349
Taargeett: calls 2349
*** FLOP *** [Jh 6d 5h]
gemmerik: checks 
Taargeett: bets 3000
gemmerik: calls 3000
*** TURN *** [Jh 6d 5h] [7h]
gemmerik: checks 
Taargeett: bets 3349 and is all-in
gemmerik: calls 3349
*** RIVER *** [Jh 6d 5h 7h] [Jc]
*** SHOW DOWN ***
gemmerik: shows [Kh Td] (a pair of Jacks)
Taargeett: shows [Kd Qh] (a pair of Jacks - King+Queen kicker)
Taargeett collected 12698 from side pot-2 
swissrabbit09: shows [Jd As] (three of a kind, Jacks)
swissrabbit09 collected 11862 from side pot-1 
carlos676754: shows [4d 4h] (two pair, Jacks and Fours)
swissrabbit09 collected 10480 from main pot
carlos676754 finished the tournament in 87th place and received 14800.
*** SUMMARY ***
Total pot 35040 Main pot 10480. Side pot-1 11862. Side pot-2 12698. | Rake 0 
Board [Jh 6d 5h 7h Jc]
Seat 1: fetis999 folded before Flop (didn't bet)
Seat 2: CyberArs folded before Flop (didn't bet)
Seat 3: Rayvas (button) folded before Flop (didn't bet)
Seat 4: gemmerik (small blind) showed [Kh Td] and lost with a pair of Jacks
Seat 5: Taargeett (big blind) showed [Kd Qh] and won (12698) with a pair of Jacks
Seat 6: carlos676754 showed [4d 4h] and lost with two pair, Jacks and Fours
Seat 7: swissrabbit09 showed [Jd As] and won (22342) with three of a kind, Jacks
Seat 8: francosil folded before Flop (didn't bet)
Seat 9: polaco43 folded before Flop (didn't bet)



PokerStars Hand #201226711382: Tournament #2620370251, 8700+1300 Hold'em No Limit - Level XII (500/1000) - 2019/06/09 12:08:32 ET
Table '2620370251 27' 9-max Seat #4 is the button
Seat 1: fetis999 (5183 in chips) is sitting out
Seat 2: CyberArs (28932 in chips) 
Seat 3: Rayvas (12751 in chips) 
Seat 4: gemmerik (5110 in chips) 
Seat 5: Taargeett (12698 in chips) 
Seat 7: swissrabbit09 (22342 in chips) 
Seat 8: francosil (6275 in chips) is sitting out
Seat 9: polaco43 (16780 in chips) 
fetis999: posts the ante 100
CyberArs: posts the ante 100
Rayvas: posts the ante 100
gemmerik: posts the ante 100
Taargeett: posts the ante 100
swissrabbit09: posts the ante 100
francosil: posts the ante 100
polaco43: posts the ante 100
Taargeett: posts small blind 500
swissrabbit09: posts big blind 1000
*** HOLE CARDS ***
Dealt to Taargeett [As 8h]
francosil: folds 
polaco43: calls 1000
fetis999: folds 
CyberArs: folds 
Rayvas: folds 
gemmerik: raises 4010 to 5010 and is all-in
Taargeett: folds 
swissrabbit09: folds 
polaco43: folds 
Uncalled bet (4010) returned to gemmerik
gemmerik collected 4300 from pot
*** SUMMARY ***
Total pot 4300 | Rake 0 
Seat 1: fetis999 folded before Flop (didn't bet)
Seat 2: CyberArs folded before Flop (didn't bet)
Seat 3: Rayvas folded before Flop (didn't bet)
Seat 4: gemmerik (button) collected (4300)
Seat 5: Taargeett (small blind) folded before Flop
Seat 7: swissrabbit09 (big blind) folded before Flop
Seat 8: francosil folded before Flop (didn't bet)
Seat 9: polaco43 folded before Flop



PokerStars Hand #201226724560: Tournament #2620370251, 8700+1300 Hold'em No Limit - Level XII (500/1000) - 2019/06/09 12:08:56 ET
Table '2620370251 27' 9-max Seat #5 is the button
Seat 1: fetis999 (5083 in chips) is sitting out
Seat 2: CyberArs (28832 in chips) 
Seat 3: Rayvas (12651 in chips) 
Seat 4: gemmerik (8310 in chips) 
Seat 5: Taargeett (12098 in chips) 
Seat 7: swissrabbit09 (21242 in chips) 
Seat 8: francosil (6175 in chips) 
Seat 9: polaco43 (15680 in chips) 
fetis999: posts the ante 100
CyberArs: posts the ante 100
Rayvas: posts the ante 100
gemmerik: posts the ante 100
Taargeett: posts the ante 100
swissrabbit09: posts the ante 100
francosil: posts the ante 100
polaco43: posts the ante 100
swissrabbit09: posts small blind 500
francosil: posts big blind 1000
*** HOLE CARDS ***
Dealt to Taargeett [Qc Qd]
polaco43: folds 
fetis999: folds 
CyberArs: calls 1000
Rayvas: folds 
gemmerik: calls 1000
Taargeett: raises 2000 to 3000
swissrabbit09: folds 
francosil: raises 3075 to 6075 and is all-in
CyberArs: folds 
gemmerik: raises 2135 to 8210 and is all-in
Taargeett: calls 5210
*** FLOP *** [6c Qs As]
*** TURN *** [6c Qs As] [9d]
*** RIVER *** [6c Qs As 9d] [7d]
*** SHOW DOWN ***
gemmerik: shows [8s 9h] (a pair of Nines)
Taargeett: shows [Qc Qd] (three of a kind, Queens)
Taargeett collected 4270 from side pot
francosil: shows [Ad Jh] (a pair of Aces)
Taargeett collected 20525 from main pot
gemmerik finished the tournament in 79th place and received 15500.
francosil finished the tournament in 80th place and received 15500.
*** SUMMARY ***
Total pot 24795 Main pot 20525. Side pot 4270. | Rake 0 
Board [6c Qs As 9d 7d]
Seat 1: fetis999 folded before Flop (didn't bet)
Seat 2: CyberArs folded before Flop
Seat 3: Rayvas folded before Flop (didn't bet)
Seat 4: gemmerik showed [8s 9h] and lost with a pair of Nines
Seat 5: Taargeett (button) showed [Qc Qd] and won (24795) with three of a kind, Queens
Seat 7: swissrabbit09 (small blind) folded before Flop
Seat 8: francosil (big blind) showed [Ad Jh] and lost with a pair of Aces
Seat 9: polaco43 folded before Flop (didn't bet)



PokerStars Hand #201226746507: Tournament #2620370251, 8700+1300 Hold'em No Limit - Level XII (500/1000) - 2019/06/09 12:09:36 ET
Table '2620370251 27' 9-max Seat #7 is the button
Seat 1: fetis999 (4983 in chips) is sitting out
Seat 2: CyberArs (27732 in chips) 
Seat 3: Rayvas (12551 in chips) 
Seat 5: Taargeett (28583 in chips) 
Seat 6: Lager420Man (17091 in chips) 
Seat 7: swissrabbit09 (20642 in chips) 
Seat 9: polaco43 (15580 in chips) 
fetis999: posts the ante 100
CyberArs: posts the ante 100
Rayvas: posts the ante 100
Taargeett: posts the ante 100
Lager420Man: posts the ante 100
swissrabbit09: posts the ante 100
polaco43: posts the ante 100
polaco43: posts small blind 500
fetis999: posts big blind 1000
*** HOLE CARDS ***
Dealt to Taargeett [Qs Jd]
CyberArs: folds 
Rayvas: folds 
Taargeett: raises 1000 to 2000
Lager420Man: folds 
swissrabbit09: calls 2000
polaco43: folds 
fetis999: folds 
*** FLOP *** [3h 8d Tc]
Taargeett: checks 
swissrabbit09: bets 1000
Taargeett: calls 1000
*** TURN *** [3h 8d Tc] [5h]
Taargeett: checks 
swissrabbit09: checks 
*** RIVER *** [3h 8d Tc 5h] [2h]
Taargeett: bets 3000
swissrabbit09: folds 
Uncalled bet (3000) returned to Taargeett
Taargeett collected 8200 from pot
Taargeett: doesn't show hand 
*** SUMMARY ***
Total pot 8200 | Rake 0 
Board [3h 8d Tc 5h 2h]
Seat 1: fetis999 (big blind) folded before Flop
Seat 2: CyberArs folded before Flop (didn't bet)
Seat 3: Rayvas folded before Flop (didn't bet)
Seat 5: Taargeett collected (8200)
Seat 6: Lager420Man folded before Flop (didn't bet)
Seat 7: swissrabbit09 (button) folded on the River
Seat 9: polaco43 (small blind) folded before Flop



PokerStars Hand #201226765662: Tournament #2620370251, 8700+1300 Hold'em No Limit - Level XII (500/1000) - 2019/06/09 12:10:10 ET
Table '2620370251 27' 9-max Seat #9 is the button
Seat 1: fetis999 (3883 in chips) is sitting out
Seat 2: CyberArs (27632 in chips) 
Seat 3: Rayvas (12451 in chips) 
Seat 4: skippy11111 (5975 in chips) 
Seat 5: Taargeett (33683 in chips) 
Seat 6: Lager420Man (16991 in chips) 
Seat 7: swissrabbit09 (17542 in chips) 
Seat 9: polaco43 (14980 in chips) 
fetis999: posts the ante 100
CyberArs: posts the ante 100
Rayvas: posts the ante 100
skippy11111: posts the ante 100
Taargeett: posts the ante 100
Lager420Man: posts the ante 100
swissrabbit09: posts the ante 100
polaco43: posts the ante 100
fetis999: posts small blind 500
CyberArs: posts big blind 1000
*** HOLE CARDS ***
Dealt to Taargeett [Qs 5h]
Rayvas: folds 
skippy11111: folds 
Taargeett: folds 
Lager420Man: raises 2000 to 3000
swissrabbit09: folds 
polaco43: folds 
fetis999: folds 
CyberArs: calls 2000
*** FLOP *** [Qc Qd Th]
CyberArs: checks 
Lager420Man: bets 5000
CyberArs: folds 
Uncalled bet (5000) returned to Lager420Man
Lager420Man collected 7300 from pot
Lager420Man: doesn't show hand 
*** SUMMARY ***
Total pot 7300 | Rake 0 
Board [Qc Qd Th]
Seat 1: fetis999 (small blind) folded before Flop
Seat 2: CyberArs (big blind) folded on the Flop
Seat 3: Rayvas folded before Flop (didn't bet)
Seat 4: skippy11111 folded before Flop (didn't bet)
Seat 5: Taargeett folded before Flop (didn't bet)
Seat 6: Lager420Man collected (7300)
Seat 7: swissrabbit09 folded before Flop (didn't bet)
Seat 9: polaco43 (button) folded before Flop (didn't bet)



PokerStars Hand #201226779533: Tournament #2620370251, 8700+1300 Hold'em No Limit - Level XII (500/1000) - 2019/06/09 12:10:36 ET
Table '2620370251 27' 9-max Seat #1 is the button
Seat 1: fetis999 (3283 in chips) is sitting out
Seat 2: CyberArs (24532 in chips) 
Seat 3: Rayvas (12351 in chips) 
Seat 4: skippy11111 (5875 in chips) 
Seat 5: Taargeett (33583 in chips) 
Seat 6: Lager420Man (21191 in chips) 
Seat 7: swissrabbit09 (17442 in chips) 
Seat 9: polaco43 (14880 in chips) 
fetis999: posts the ante 100
CyberArs: posts the ante 100
Rayvas: posts the ante 100
skippy11111: posts the ante 100
Taargeett: posts the ante 100
Lager420Man: posts the ante 100
swissrabbit09: posts the ante 100
polaco43: posts the ante 100
CyberArs: posts small blind 500
Rayvas: posts big blind 1000
*** HOLE CARDS ***
Dealt to Taargeett [Kd 8s]
skippy11111: raises 4000 to 5000
Taargeett: folds 
Lager420Man: folds 
swissrabbit09: folds 
polaco43: folds 
fetis999: folds 
CyberArs: calls 4500
Rayvas: folds 
*** FLOP *** [7d 6s Qd]
CyberArs: bets 1000
skippy11111: calls 775 and is all-in
Uncalled bet (225) returned to CyberArs
*** TURN *** [7d 6s Qd] [4h]
*** RIVER *** [7d 6s Qd 4h] [Js]
*** SHOW DOWN ***
CyberArs: shows [7c Ad] (a pair of Sevens)
skippy11111: shows [Ah As] (a pair of Aces)
skippy11111 collected 13350 from pot
*** SUMMARY ***
Total pot 13350 | Rake 0 
Board [7d 6s Qd 4h Js]
Seat 1: fetis999 (button) folded before Flop (didn't bet)
Seat 2: CyberArs (small blind) showed [7c Ad] and lost with a pair of Sevens
Seat 3: Rayvas (big blind) folded before Flop
Seat 4: skippy11111 showed [Ah As] and won (13350) with a pair of Aces
Seat 5: Taargeett folded before Flop (didn't bet)
Seat 6: Lager420Man folded before Flop (didn't bet)
Seat 7: swissrabbit09 folded before Flop (didn't bet)
Seat 9: polaco43 folded before Flop (didn't bet)



PokerStars Hand #201226798620: Tournament #2620370251, 8700+1300 Hold'em No Limit - Level XII (500/1000) - 2019/06/09 12:11:10 ET
Table '2620370251 27' 9-max Seat #2 is the button
Seat 1: fetis999 (3183 in chips) is sitting out
Seat 2: CyberArs (18657 in chips) 
Seat 3: Rayvas (11251 in chips) 
Seat 4: skippy11111 (13350 in chips) 
Seat 5: Taargeett (33483 in chips) 
Seat 6: Lager420Man (21091 in chips) 
Seat 7: swissrabbit09 (17342 in chips) 
Seat 9: polaco43 (14780 in chips) 
fetis999: posts the ante 100
CyberArs: posts the ante 100
Rayvas: posts the ante 100
skippy11111: posts the ante 100
Taargeett: posts the ante 100
Lager420Man: posts the ante 100
swissrabbit09: posts the ante 100
polaco43: posts the ante 100
Rayvas: posts small blind 500
skippy11111: posts big blind 1000
*** HOLE CARDS ***
Dealt to Taargeett [2s Tc]
Taargeett: folds 
Lager420Man: folds 
swissrabbit09: calls 1000
polaco43: calls 1000
fetis999: folds 
CyberArs: folds 
Rayvas: folds 
skippy11111: checks 
*** FLOP *** [3d 3s 8h]
skippy11111: checks 
swissrabbit09: checks 
polaco43: bets 1000
skippy11111: folds 
swissrabbit09: folds 
Uncalled bet (1000) returned to polaco43
polaco43 collected 4300 from pot
polaco43: doesn't show hand 
*** SUMMARY ***
Total pot 4300 | Rake 0 
Board [3d 3s 8h]
Seat 1: fetis999 folded before Flop (didn't bet)
Seat 2: CyberArs (button) folded before Flop (didn't bet)
Seat 3: Rayvas (small blind) folded before Flop
Seat 4: skippy11111 (big blind) folded on the Flop
Seat 5: Taargeett folded before Flop (didn't bet)
Seat 6: Lager420Man folded before Flop (didn't bet)
Seat 7: swissrabbit09 folded on the Flop
Seat 9: polaco43 collected (4300)



PokerStars Hand #201226815882: Tournament #2620370251, 8700+1300 Hold'em No Limit - Level XII (500/1000) - 2019/06/09 12:11:42 ET
Table '2620370251 27' 9-max Seat #3 is the button
Seat 1: fetis999 (3083 in chips) is sitting out
Seat 2: CyberArs (18557 in chips) 
Seat 3: Rayvas (10651 in chips) 
Seat 4: skippy11111 (12250 in chips) 
Seat 5: Taargeett (33383 in chips) 
Seat 6: Lager420Man (20991 in chips) 
Seat 7: swissrabbit09 (16242 in chips) 
Seat 8: Asskaret (17151 in chips) 
Seat 9: polaco43 (17980 in chips) 
fetis999: posts the ante 100
CyberArs: posts the ante 100
Rayvas: posts the ante 100
skippy11111: posts the ante 100
Taargeett: posts the ante 100
Lager420Man: posts the ante 100
swissrabbit09: posts the ante 100
Asskaret: posts the ante 100
polaco43: posts the ante 100
skippy11111: posts small blind 500
Taargeett: posts big blind 1000
*** HOLE CARDS ***
Dealt to Taargeett [7c Jc]
Lager420Man: folds 
swissrabbit09: folds 
Asskaret: folds 
polaco43: calls 1000
fetis999: folds 
CyberArs: calls 1000
Rayvas: folds 
skippy11111: folds 
Taargeett: raises 1000 to 2000
polaco43: calls 1000
CyberArs: calls 1000
*** FLOP *** [Kd 8s Kh]
Taargeett: checks 
polaco43: checks 
CyberArs: checks 
*** TURN *** [Kd 8s Kh] [9s]
Taargeett: bets 2000
polaco43: folds 
CyberArs: calls 2000
*** RIVER *** [Kd 8s Kh 9s] [8d]
Taargeett: bets 3000
CyberArs: calls 3000
*** SHOW DOWN ***
Taargeett: shows [7c Jc] (two pair, Kings and Eights)
CyberArs: shows [2d Qd] (two pair, Kings and Eights - Queen kicker)
CyberArs collected 17400 from pot
*** SUMMARY ***
Total pot 17400 | Rake 0 
Board [Kd 8s Kh 9s 8d]
Seat 1: fetis999 folded before Flop (didn't bet)
Seat 2: CyberArs showed [2d Qd] and won (17400) with two pair, Kings and Eights
Seat 3: Rayvas (button) folded before Flop (didn't bet)
Seat 4: skippy11111 (small blind) folded before Flop
Seat 5: Taargeett (big blind) showed [7c Jc] and lost with two pair, Kings and Eights
Seat 6: Lager420Man folded before Flop (didn't bet)
Seat 7: swissrabbit09 folded before Flop (didn't bet)
Seat 8: Asskaret folded before Flop (didn't bet)
Seat 9: polaco43 folded on the Turn



PokerStars Hand #201226845023: Tournament #2620370251, 8700+1300 Hold'em No Limit - Level XIII (600/1200) - 2019/06/09 12:12:35 ET
Table '2620370251 27' 9-max Seat #4 is the button
Seat 1: fetis999 (2983 in chips) is sitting out
Seat 2: CyberArs (28857 in chips) 
Seat 3: Rayvas (10551 in chips) 
Seat 4: skippy11111 (11650 in chips) 
Seat 5: Taargeett (26283 in chips) 
Seat 6: Lager420Man (20891 in chips) 
Seat 7: swissrabbit09 (16142 in chips) 
Seat 8: Asskaret (17051 in chips) 
Seat 9: polaco43 (15880 in chips) 
fetis999: posts the ante 125
CyberArs: posts the ante 125
Rayvas: posts the ante 125
skippy11111: posts the ante 125
Taargeett: posts the ante 125
Lager420Man: posts the ante 125
swissrabbit09: posts the ante 125
Asskaret: posts the ante 125
polaco43: posts the ante 125
Taargeett: posts small blind 600
Lager420Man: posts big blind 1200
*** HOLE CARDS ***
Dealt to Taargeett [Ac 3h]
swissrabbit09: raises 1200 to 2400
Asskaret: folds 
polaco43: folds 
fetis999: folds 
CyberArs: calls 2400
Rayvas: folds 
skippy11111: folds 
Taargeett: folds 
Lager420Man: folds 
*** FLOP *** [2d Td 7h]
swissrabbit09: bets 1200
CyberArs: calls 1200
*** TURN *** [2d Td 7h] [9c]
swissrabbit09: bets 1200
CyberArs: calls 1200
*** RIVER *** [2d Td 7h 9c] [Qc]
swissrabbit09: bets 1200
CyberArs: calls 1200
*** SHOW DOWN ***
swissrabbit09: shows [8h 8d] (a pair of Eights)
CyberArs: shows [Jd Qs] (a pair of Queens)
CyberArs collected 14925 from pot
*** SUMMARY ***
Total pot 14925 | Rake 0 
Board [2d Td 7h 9c Qc]
Seat 1: fetis999 folded before Flop (didn't bet)
Seat 2: CyberArs showed [Jd Qs] and won (14925) with a pair of Queens
Seat 3: Rayvas folded before Flop (didn't bet)
Seat 4: skippy11111 (button) folded before Flop (didn't bet)
Seat 5: Taargeett (small blind) folded before Flop
Seat 6: Lager420Man (big blind) folded before Flop
Seat 7: swissrabbit09 showed [8h 8d] and lost with a pair of Eights
Seat 8: Asskaret folded before Flop (didn't bet)
Seat 9: polaco43 folded before Flop (didn't bet)



PokerStars Hand #201226864416: Tournament #2620370251, 8700+1300 Hold'em No Limit - Level XIII (600/1200) - 2019/06/09 12:13:10 ET
Table '2620370251 27' 9-max Seat #5 is the button
Seat 1: fetis999 (2858 in chips) is sitting out
Seat 2: CyberArs (37657 in chips) 
Seat 3: Rayvas (10426 in chips) 
Seat 4: skippy11111 (11525 in chips) 
Seat 5: Taargeett (25558 in chips) 
Seat 6: Lager420Man (19566 in chips) 
Seat 7: swissrabbit09 (10017 in chips) 
Seat 8: Asskaret (16926 in chips) 
Seat 9: polaco43 (15755 in chips) 
fetis999: posts the ante 125
CyberArs: posts the ante 125
Rayvas: posts the ante 125
skippy11111: posts the ante 125
Taargeett: posts the ante 125
Lager420Man: posts the ante 125
swissrabbit09: posts the ante 125
Asskaret: posts the ante 125
polaco43: posts the ante 125
Lager420Man: posts small blind 600
swissrabbit09: posts big blind 1200
*** HOLE CARDS ***
Dealt to Taargeett [5h 5s]
Asskaret: folds 
polaco43: folds 
fetis999: folds 
CyberArs: folds 
Rayvas: folds 
skippy11111: folds 
Taargeett: raises 2400 to 3600
Lager420Man: folds 
swissrabbit09: folds 
Uncalled bet (2400) returned to Taargeett
Taargeett collected 4125 from pot
Taargeett: doesn't show hand 
*** SUMMARY ***
Total pot 4125 | Rake 0 
Seat 1: fetis999 folded before Flop (didn't bet)
Seat 2: CyberArs folded before Flop (didn't bet)
Seat 3: Rayvas folded before Flop (didn't bet)
Seat 4: skippy11111 folded before Flop (didn't bet)
Seat 5: Taargeett (button) collected (4125)
Seat 6: Lager420Man (small blind) folded before Flop
Seat 7: swissrabbit09 (big blind) folded before Flop
Seat 8: Asskaret folded before Flop (didn't bet)
Seat 9: polaco43 folded before Flop (didn't bet)



PokerStars Hand #201226877219: Tournament #2620370251, 8700+1300 Hold'em No Limit - Level XIII (600/1200) - 2019/06/09 12:13:34 ET
Table '2620370251 27' 9-max Seat #6 is the button
Seat 1: fetis999 (2733 in chips) is sitting out
Seat 2: CyberArs (37532 in chips) 
Seat 3: Rayvas (10301 in chips) 
Seat 4: skippy11111 (11400 in chips) 
Seat 5: Taargeett (28358 in chips) 
Seat 6: Lager420Man (18841 in chips) 
Seat 7: swissrabbit09 (8692 in chips) 
Seat 8: Asskaret (16801 in chips) 
Seat 9: polaco43 (15630 in chips) 
fetis999: posts the ante 125
CyberArs: posts the ante 125
Rayvas: posts the ante 125
skippy11111: posts the ante 125
Taargeett: posts the ante 125
Lager420Man: posts the ante 125
swissrabbit09: posts the ante 125
Asskaret: posts the ante 125
polaco43: posts the ante 125
swissrabbit09: posts small blind 600
Asskaret: posts big blind 1200
*** HOLE CARDS ***
Dealt to Taargeett [7h Qs]
polaco43: calls 1200
fetis999: folds 
CyberArs: folds 
Rayvas: folds 
skippy11111: folds 
Taargeett: folds 
Lager420Man: folds 
swissrabbit09: calls 600
Asskaret: checks 
*** FLOP *** [Ad 4c Kh]
swissrabbit09: checks 
Asskaret: checks 
polaco43: checks 
*** TURN *** [Ad 4c Kh] [Tc]
swissrabbit09: checks 
Asskaret: bets 2400
polaco43: folds 
swissrabbit09: folds 
Uncalled bet (2400) returned to Asskaret
Asskaret collected 4725 from pot
Asskaret: doesn't show hand 
*** SUMMARY ***
Total pot 4725 | Rake 0 
Board [Ad 4c Kh Tc]
Seat 1: fetis999 folded before Flop (didn't bet)
Seat 2: CyberArs folded before Flop (didn't bet)
Seat 3: Rayvas folded before Flop (didn't bet)
Seat 4: skippy11111 folded before Flop (didn't bet)
Seat 5: Taargeett folded before Flop (didn't bet)
Seat 6: Lager420Man (button) folded before Flop (didn't bet)
Seat 7: swissrabbit09 (small blind) folded on the Turn
Seat 8: Asskaret (big blind) collected (4725)
Seat 9: polaco43 folded on the Turn



PokerStars Hand #201226901096: Tournament #2620370251, 8700+1300 Hold'em No Limit - Level XIII (600/1200) - 2019/06/09 12:14:18 ET
Table '2620370251 27' 9-max Seat #7 is the button
Seat 1: fetis999 (2608 in chips) is sitting out
Seat 2: CyberArs (37407 in chips) 
Seat 3: Rayvas (10176 in chips) 
Seat 4: skippy11111 (11275 in chips) 
Seat 5: Taargeett (28233 in chips) 
Seat 6: Lager420Man (18716 in chips) 
Seat 7: swissrabbit09 (7367 in chips) 
Seat 8: Asskaret (20201 in chips) 
Seat 9: polaco43 (14305 in chips) 
fetis999: posts the ante 125
CyberArs: posts the ante 125
Rayvas: posts the ante 125
skippy11111: posts the ante 125
Taargeett: posts the ante 125
Lager420Man: posts the ante 125
swissrabbit09: posts the ante 125
Asskaret: posts the ante 125
polaco43: posts the ante 125
Asskaret: posts small blind 600
polaco43: posts big blind 1200
*** HOLE CARDS ***
Dealt to Taargeett [5d 7d]
fetis999: folds 
CyberArs: calls 1200
Rayvas: folds 
skippy11111: folds 
Taargeett: raises 1200 to 2400
Lager420Man: folds 
swissrabbit09: folds 
Asskaret: folds 
polaco43: folds 
CyberArs: calls 1200
*** FLOP *** [8c 2d 9s]
CyberArs: checks 
Taargeett: bets 3600
CyberArs: calls 3600
*** TURN *** [8c 2d 9s] [Kd]
CyberArs: checks 
Taargeett: checks 
*** RIVER *** [8c 2d 9s Kd] [Ac]
CyberArs: bets 2400
Taargeett: folds 
Uncalled bet (2400) returned to CyberArs
CyberArs collected 14925 from pot
CyberArs: doesn't show hand 
*** SUMMARY ***
Total pot 14925 | Rake 0 
Board [8c 2d 9s Kd Ac]
Seat 1: fetis999 folded before Flop (didn't bet)
Seat 2: CyberArs collected (14925)
Seat 3: Rayvas folded before Flop (didn't bet)
Seat 4: skippy11111 folded before Flop (didn't bet)
Seat 5: Taargeett folded on the River
Seat 6: Lager420Man folded before Flop (didn't bet)
Seat 7: swissrabbit09 (button) folded before Flop (didn't bet)
Seat 8: Asskaret (small blind) folded before Flop
Seat 9: polaco43 (big blind) folded before Flop



PokerStars Hand #201226926715: Tournament #2620370251, 8700+1300 Hold'em No Limit - Level XIII (600/1200) - 2019/06/09 12:15:05 ET
Table '2620370251 27' 9-max Seat #8 is the button
Seat 1: fetis999 (2483 in chips) is sitting out
Seat 2: CyberArs (46207 in chips) 
Seat 3: Rayvas (10051 in chips) 
Seat 4: skippy11111 (11150 in chips) 
Seat 5: Taargeett (22108 in chips) 
Seat 6: Lager420Man (18591 in chips) 
Seat 7: swissrabbit09 (7242 in chips) 
Seat 8: Asskaret (19476 in chips) 
Seat 9: polaco43 (12980 in chips) 
fetis999: posts the ante 125
CyberArs: posts the ante 125
Rayvas: posts the ante 125
skippy11111: posts the ante 125
Taargeett: posts the ante 125
Lager420Man: posts the ante 125
swissrabbit09: posts the ante 125
Asskaret: posts the ante 125
polaco43: posts the ante 125
polaco43: posts small blind 600
fetis999: posts big blind 1200
*** HOLE CARDS ***
Dealt to Taargeett [Qc 4d]
CyberArs: calls 1200
Rayvas: folds 
skippy11111: folds 
Taargeett: folds 
Lager420Man: calls 1200
swissrabbit09: calls 1200
Asskaret: folds 
polaco43: folds 
fetis999: folds 
*** FLOP *** [7c 9d 6s]
CyberArs: bets 1200
Lager420Man: calls 1200
swissrabbit09: folds 
*** TURN *** [7c 9d 6s] [3s]
CyberArs: bets 4463
Lager420Man: folds 
Uncalled bet (4463) returned to CyberArs
CyberArs collected 8925 from pot
CyberArs: doesn't show hand 
*** SUMMARY ***
Total pot 8925 | Rake 0 
Board [7c 9d 6s 3s]
Seat 1: fetis999 (big blind) folded before Flop
Seat 2: CyberArs collected (8925)
Seat 3: Rayvas folded before Flop (didn't bet)
Seat 4: skippy11111 folded before Flop (didn't bet)
Seat 5: Taargeett folded before Flop (didn't bet)
Seat 6: Lager420Man folded on the Turn
Seat 7: swissrabbit09 folded on the Flop
Seat 8: Asskaret (button) folded before Flop (didn't bet)
Seat 9: polaco43 (small blind) folded before Flop



PokerStars Hand #201226955593: Tournament #2620370251, 8700+1300 Hold'em No Limit - Level XIII (600/1200) - 2019/06/09 12:15:57 ET
Table '2620370251 31' 9-max Seat #6 is the button
Seat 1: chaggi23 (1648 in chips) is sitting out
Seat 2: Taargeett (21983 in chips) 
Seat 3: Anuoar (37078 in chips) 
Seat 4: Echnaton I. (6688 in chips) 
Seat 6: ros2573 (24179 in chips) 
Seat 7: johnny reds (42446 in chips) 
Seat 8: kison11 (47780 in chips) 
Seat 9: pokir rup (7170 in chips) 
chaggi23: posts the ante 125
Taargeett: posts the ante 125
Anuoar: posts the ante 125
Echnaton I.: posts the ante 125
ros2573: posts the ante 125
johnny reds: posts the ante 125
kison11: posts the ante 125
pokir rup: posts the ante 125
johnny reds: posts small blind 600
kison11: posts big blind 1200
*** HOLE CARDS ***
Dealt to Taargeett [9s 8h]
pokir rup: folds 
chaggi23: folds 
Taargeett: folds 
Anuoar: folds 
Echnaton I.: folds 
ros2573: folds 
johnny reds: calls 600
kison11: checks 
*** FLOP *** [Qs 3c Js]
johnny reds: checks 
kison11: checks 
*** TURN *** [Qs 3c Js] [Ts]
johnny reds: bets 1200
kison11: folds 
Uncalled bet (1200) returned to johnny reds
johnny reds collected 3400 from pot
johnny reds: doesn't show hand 
*** SUMMARY ***
Total pot 3400 | Rake 0 
Board [Qs 3c Js Ts]
Seat 1: chaggi23 folded before Flop (didn't bet)
Seat 2: Taargeett folded before Flop (didn't bet)
Seat 3: Anuoar folded before Flop (didn't bet)
Seat 4: Echnaton I. folded before Flop (didn't bet)
Seat 6: ros2573 (button) folded before Flop (didn't bet)
Seat 7: johnny reds (small blind) collected (3400)
Seat 8: kison11 (big blind) folded on the Turn
Seat 9: pokir rup folded before Flop (didn't bet)



PokerStars Hand #201226971633: Tournament #2620370251, 8700+1300 Hold'em No Limit - Level XIII (600/1200) - 2019/06/09 12:16:26 ET
Table '2620370251 31' 9-max Seat #7 is the button
Seat 1: chaggi23 (1523 in chips) is sitting out
Seat 2: Taargeett (21858 in chips) 
Seat 3: Anuoar (36953 in chips) 
Seat 4: Echnaton I. (6563 in chips) 
Seat 6: ros2573 (24054 in chips) 
Seat 7: johnny reds (44521 in chips) 
Seat 8: kison11 (46455 in chips) 
Seat 9: pokir rup (7045 in chips) 
chaggi23: posts the ante 125
Taargeett: posts the ante 125
Anuoar: posts the ante 125
Echnaton I.: posts the ante 125
ros2573: posts the ante 125
johnny reds: posts the ante 125
kison11: posts the ante 125
pokir rup: posts the ante 125
kison11: posts small blind 600
pokir rup: posts big blind 1200
*** HOLE CARDS ***
Dealt to Taargeett [Kh 9c]
chaggi23: folds 
Taargeett: folds 
Anuoar: folds 
Echnaton I.: folds 
ros2573: folds 
johnny reds: calls 1200
kison11: raises 1200 to 2400
pokir rup: raises 4520 to 6920 and is all-in
johnny reds: calls 5720
kison11: calls 4520
*** FLOP *** [9d Jc Ah]
kison11: bets 1200
johnny reds: calls 1200
*** TURN *** [9d Jc Ah] [3c]
kison11: bets 2400
johnny reds: calls 2400
*** RIVER *** [9d Jc Ah 3c] [7d]
kison11: bets 3600
johnny reds: calls 3600
*** SHOW DOWN ***
kison11: shows [Qs Js] (a pair of Jacks)
johnny reds: shows [Ac 4d] (a pair of Aces)
johnny reds collected 14400 from side pot
pokir rup: mucks hand 
johnny reds collected 21760 from main pot
pokir rup finished the tournament in 53rd place and received 19000.
*** SUMMARY ***
Total pot 36160 Main pot 21760. Side pot 14400. | Rake 0 
Board [9d Jc Ah 3c 7d]
Seat 1: chaggi23 folded before Flop (didn't bet)
Seat 2: Taargeett folded before Flop (didn't bet)
Seat 3: Anuoar folded before Flop (didn't bet)
Seat 4: Echnaton I. folded before Flop (didn't bet)
Seat 6: ros2573 folded before Flop (didn't bet)
Seat 7: johnny reds (button) showed [Ac 4d] and won (36160) with a pair of Aces
Seat 8: kison11 (small blind) showed [Qs Js] and lost with a pair of Jacks
Seat 9: pokir rup (big blind) mucked [8h 8c]



PokerStars Hand #201226994282: Tournament #2620370251, 8700+1300 Hold'em No Limit - Level XIV (800/1600) - 2019/06/09 12:17:08 ET
Table '2620370251 31' 9-max Seat #8 is the button
Seat 1: chaggi23 (1398 in chips) is sitting out
Seat 2: Taargeett (21733 in chips) 
Seat 3: Anuoar (36828 in chips) 
Seat 4: Echnaton I. (6438 in chips) 
Seat 5: Liimbou (41221 in chips) 
Seat 6: ros2573 (23929 in chips) 
Seat 7: johnny reds (66436 in chips) 
Seat 8: kison11 (32210 in chips) 
chaggi23: posts the ante 150
Taargeett: posts the ante 150
Anuoar: posts the ante 150
Echnaton I.: posts the ante 150
Liimbou: posts the ante 150
ros2573: posts the ante 150
johnny reds: posts the ante 150
kison11: posts the ante 150
chaggi23: posts small blind 800
Taargeett: posts big blind 1600
*** HOLE CARDS ***
Dealt to Taargeett [Qc 8s]
Anuoar: folds 
Echnaton I.: folds 
Liimbou: folds 
ros2573: folds 
johnny reds: calls 1600
kison11: folds 
chaggi23: folds 
Taargeett: checks 
*** FLOP *** [Qh 8d 6d]
Taargeett: bets 1600
johnny reds: calls 1600
*** TURN *** [Qh 8d 6d] [Ts]
Taargeett: bets 4800
johnny reds: folds 
Uncalled bet (4800) returned to Taargeett
Taargeett collected 8400 from pot
Taargeett: doesn't show hand 
*** SUMMARY ***
Total pot 8400 | Rake 0 
Board [Qh 8d 6d Ts]
Seat 1: chaggi23 (small blind) folded before Flop
Seat 2: Taargeett (big blind) collected (8400)
Seat 3: Anuoar folded before Flop (didn't bet)
Seat 4: Echnaton I. folded before Flop (didn't bet)
Seat 5: Liimbou folded before Flop (didn't bet)
Seat 6: ros2573 folded before Flop (didn't bet)
Seat 7: johnny reds folded on the Turn
Seat 8: kison11 (button) folded before Flop (didn't bet)



PokerStars Hand #201227010553: Tournament #2620370251, 8700+1300 Hold'em No Limit - Level XIV (800/1600) - 2019/06/09 12:17:37 ET
Table '2620370251 31' 9-max Seat #1 is the button
Seat 1: chaggi23 (448 in chips) is sitting out
Seat 2: Taargeett (26783 in chips) 
Seat 3: Anuoar (36678 in chips) 
Seat 4: Echnaton I. (6288 in chips) 
Seat 5: Liimbou (41071 in chips) 
Seat 6: ros2573 (23779 in chips) 
Seat 7: johnny reds (63086 in chips) 
Seat 8: kison11 (32060 in chips) 
chaggi23: posts the ante 150
Taargeett: posts the ante 150
Anuoar: posts the ante 150
Echnaton I.: posts the ante 150
Liimbou: posts the ante 150
ros2573: posts the ante 150
johnny reds: posts the ante 150
kison11: posts the ante 150
Taargeett: posts small blind 800
Anuoar: posts big blind 1600
*** HOLE CARDS ***
Dealt to Taargeett [Kd Jh]
Echnaton I.: folds 
Liimbou: folds 
ros2573: calls 1600
johnny reds: calls 1600
kison11: folds 
chaggi23: folds 
Taargeett: raises 3200 to 4800
Anuoar: raises 31728 to 36528 and is all-in
ros2573: folds 
johnny reds: folds 
Taargeett: calls 21833 and is all-in
Uncalled bet (9895) returned to Anuoar
*** FLOP *** [2h 8h Td]
*** TURN *** [2h 8h Td] [6h]
*** RIVER *** [2h 8h Td 6h] [2s]
*** SHOW DOWN ***
Taargeett: shows [Kd Jh] (a pair of Deuces)
Anuoar: shows [Ad Ks] (a pair of Deuces - Ace kicker)
Anuoar collected 57666 from pot
Taargeett finished the tournament in 48th place and received 19000.
*** SUMMARY ***
Total pot 57666 | Rake 0 
Board [2h 8h Td 6h 2s]
Seat 1: chaggi23 (button) folded before Flop (didn't bet)
Seat 2: Taargeett (small blind) showed [Kd Jh] and lost with a pair of Deuces
Seat 3: Anuoar (big blind) showed [Ad Ks] and won (57666) with a pair of Deuces
Seat 4: Echnaton I. folded before Flop (didn't bet)
Seat 5: Liimbou folded before Flop (didn't bet)
Seat 6: ros2573 folded before Flop
Seat 7: johnny reds folded before Flop
Seat 8: kison11 folded before Flop (didn't bet)



