PokerStars Hand #201497139887: Tournament #2629783708, 8700+1300 Hold'em No Limit - Level I (10/20) - 2019/06/17 22:05:02 ET
Table '2629783708 15' 9-max Seat #1 is the button
Seat 1: LuciaKrapp (1500 in chips) 
Seat 2: Taargeett (1500 in chips) 
Seat 3: axamoses (1500 in chips) 
Seat 4: shnanou (1500 in chips) 
Seat 5: BorgesAAKK (1500 in chips) 
Seat 6: mmaatthh (1500 in chips) 
Seat 7: Cooki2759 (1500 in chips) 
Seat 8: Luís Soeiro 28 (1500 in chips) 
Seat 9: danilo141008 (1500 in chips) 
Taargeett: posts small blind 10
axamoses: posts big blind 20
*** HOLE CARDS ***
Dealt to Taargeett [7d Ah]
shnanou: calls 20
BorgesAAKK: folds 
mmaatthh: folds 
Cooki2759 is connected 
Cooki2759: raises 20 to 40
Luís Soeiro 28: folds 
danilo141008: calls 40
LuciaKrapp: calls 40
Taargeett: folds 
axamoses: raises 40 to 80
shnanou: calls 60
Cooki2759: calls 40
danilo141008: calls 40
LuciaKrapp: calls 40
*** FLOP *** [9c 9h 6d]
axamoses: bets 80
shnanou: folds 
Cooki2759: folds 
danilo141008: calls 80
LuciaKrapp: calls 80
*** TURN *** [9c 9h 6d] [3h]
axamoses: bets 640
danilo141008: calls 640
LuciaKrapp: calls 640
*** RIVER *** [9c 9h 6d 3h] [4s]
axamoses: bets 700 and is all-in
danilo141008: calls 700 and is all-in
LuciaKrapp: calls 700 and is all-in
*** SHOW DOWN ***
axamoses: shows [Ac 4c] (two pair, Nines and Fours)
danilo141008: shows [6h 5s] (two pair, Nines and Sixes)
LuciaKrapp: shows [5c 5h] (two pair, Nines and Fives)
danilo141008 collected 4670 from pot
LuciaKrapp finished the tournament
axamoses finished the tournament
*** SUMMARY ***
Total pot 4670 | Rake 0 
Board [9c 9h 6d 3h 4s]
Seat 1: LuciaKrapp (button) showed [5c 5h] and lost with two pair, Nines and Fives
Seat 2: Taargeett (small blind) folded before Flop
Seat 3: axamoses (big blind) showed [Ac 4c] and lost with two pair, Nines and Fours
Seat 4: shnanou folded on the Flop
Seat 5: BorgesAAKK folded before Flop (didn't bet)
Seat 6: mmaatthh folded before Flop (didn't bet)
Seat 7: Cooki2759 folded on the Flop
Seat 8: Luís Soeiro 28 folded before Flop (didn't bet)
Seat 9: danilo141008 showed [6h 5s] and won (4670) with two pair, Nines and Sixes



PokerStars Hand #201497173589: Tournament #2629783708, 8700+1300 Hold'em No Limit - Level I (10/20) - 2019/06/17 22:07:15 ET
Table '2629783708 15' 9-max Seat #2 is the button
Seat 2: Taargeett (1490 in chips) 
Seat 4: shnanou (1420 in chips) 
Seat 5: BorgesAAKK (1500 in chips) 
Seat 6: mmaatthh (1500 in chips) 
Seat 7: Cooki2759 (1420 in chips) 
Seat 8: Luís Soeiro 28 (1500 in chips) 
Seat 9: danilo141008 (4670 in chips) 
shnanou: posts small blind 10
BorgesAAKK: posts big blind 20
*** HOLE CARDS ***
Dealt to Taargeett [5d As]
mmaatthh: folds 
Cooki2759: raises 40 to 60
Luís Soeiro 28: calls 60
danilo141008: calls 60
Taargeett: folds 
shnanou: calls 50
BorgesAAKK: folds 
*** FLOP *** [Js Ac Kh]
shnanou: checks 
Cooki2759: bets 130
Luís Soeiro 28: folds 
danilo141008: calls 130
shnanou: calls 130
*** TURN *** [Js Ac Kh] [3h]
shnanou: checks 
Cooki2759: bets 325
danilo141008: calls 325
shnanou: folds 
*** RIVER *** [Js Ac Kh 3h] [9d]
Cooki2759: bets 650
danilo141008: calls 650
*** SHOW DOWN ***
Cooki2759: shows [Qs Ah] (a pair of Aces)
danilo141008: shows [3d Jc] (two pair, Jacks and Threes)
danilo141008 collected 2600 from pot
*** SUMMARY ***
Total pot 2600 | Rake 0 
Board [Js Ac Kh 3h 9d]
Seat 2: Taargeett (button) folded before Flop (didn't bet)
Seat 4: shnanou (small blind) folded on the Turn
Seat 5: BorgesAAKK (big blind) folded before Flop
Seat 6: mmaatthh folded before Flop (didn't bet)
Seat 7: Cooki2759 showed [Qs Ah] and lost with a pair of Aces
Seat 8: Luís Soeiro 28 folded on the Flop
Seat 9: danilo141008 showed [3d Jc] and won (2600) with two pair, Jacks and Threes



PokerStars Hand #201497193992: Tournament #2629783708, 8700+1300 Hold'em No Limit - Level I (10/20) - 2019/06/17 22:08:37 ET
Table '2629783708 15' 9-max Seat #5 is the button
Seat 1: Gabriel00228 (1200 in chips) 
Seat 2: Taargeett (1490 in chips) 
Seat 3: MiJulz (1500 in chips) 
Seat 5: BorgesAAKK (1480 in chips) 
Seat 6: mmaatthh (1500 in chips) 
Seat 7: Cooki2759 (255 in chips) 
Seat 8: Luís Soeiro 28 (1440 in chips) 
Seat 9: danilo141008 (6105 in chips) 
mmaatthh: posts small blind 10
Cooki2759: posts big blind 20
*** HOLE CARDS ***
Dealt to Taargeett [3s Jd]
Luís Soeiro 28: calls 20
danilo141008: calls 20
Gabriel00228: raises 90 to 110
Taargeett: folds 
MiJulz: folds 
BorgesAAKK: folds 
mmaatthh: folds 
Cooki2759: folds 
Luís Soeiro 28: calls 90
danilo141008: calls 90
*** FLOP *** [6s Td 2d]
Luís Soeiro 28: checks 
danilo141008: checks 
Gabriel00228: bets 360
Luís Soeiro 28: folds 
danilo141008: calls 360
*** TURN *** [6s Td 2d] [2s]
danilo141008: checks 
Gabriel00228: bets 540
danilo141008: calls 540
*** RIVER *** [6s Td 2d 2s] [6c]
danilo141008: checks 
Gabriel00228: bets 190 and is all-in
danilo141008: calls 190
*** SHOW DOWN ***
Gabriel00228: shows [Kc 9d] (two pair, Sixes and Deuces)
danilo141008: shows [Ts Jc] (two pair, Tens and Sixes)
danilo141008 collected 2540 from pot
Gabriel00228 finished the tournament
*** SUMMARY ***
Total pot 2540 | Rake 0 
Board [6s Td 2d 2s 6c]
Seat 1: Gabriel00228 showed [Kc 9d] and lost with two pair, Sixes and Deuces
Seat 2: Taargeett folded before Flop (didn't bet)
Seat 3: MiJulz folded before Flop (didn't bet)
Seat 5: BorgesAAKK (button) folded before Flop (didn't bet)
Seat 6: mmaatthh (small blind) folded before Flop
Seat 7: Cooki2759 (big blind) folded before Flop
Seat 8: Luís Soeiro 28 folded on the Flop
Seat 9: danilo141008 showed [Ts Jc] and won (2540) with two pair, Tens and Sixes



PokerStars Hand #201497212233: Tournament #2629783708, 8700+1300 Hold'em No Limit - Level I (10/20) - 2019/06/17 22:09:50 ET
Table '2629783708 15' 9-max Seat #6 is the button
Seat 2: Taargeett (1490 in chips) 
Seat 3: MiJulz (1500 in chips) 
Seat 4: CRASH8 (1500 in chips) 
Seat 5: BorgesAAKK (1480 in chips) 
Seat 6: mmaatthh (1490 in chips) 
Seat 7: Cooki2759 (235 in chips) 
Seat 8: Luís Soeiro 28 (1330 in chips) 
Seat 9: danilo141008 (7445 in chips) 
Cooki2759: posts small blind 10
Luís Soeiro 28: posts big blind 20
*** HOLE CARDS ***
Dealt to Taargeett [6c Qd]
danilo141008: calls 20
Taargeett: folds 
MiJulz: calls 20
CRASH8: folds 
BorgesAAKK: folds 
mmaatthh: raises 60 to 80
Cooki2759: calls 70
Luís Soeiro 28: calls 60
danilo141008: calls 60
MiJulz: calls 60
*** FLOP *** [7s 8c Jc]
Cooki2759: bets 155 and is all-in
Luís Soeiro 28: calls 155
danilo141008: calls 155
MiJulz: folds 
mmaatthh: folds 
*** TURN *** [7s 8c Jc] [8s]
Luís Soeiro 28: checks 
danilo141008: bets 7210 and is all-in
Luís Soeiro 28: folds 
Uncalled bet (7210) returned to danilo141008
*** RIVER *** [7s 8c Jc 8s] [5h]
*** SHOW DOWN ***
Cooki2759: shows [Tc Jd] (two pair, Jacks and Eights)
danilo141008: shows [6d 6h] (two pair, Eights and Sixes)
Cooki2759 collected 865 from pot
*** SUMMARY ***
Total pot 865 | Rake 0 
Board [7s 8c Jc 8s 5h]
Seat 2: Taargeett folded before Flop (didn't bet)
Seat 3: MiJulz folded on the Flop
Seat 4: CRASH8 folded before Flop (didn't bet)
Seat 5: BorgesAAKK folded before Flop (didn't bet)
Seat 6: mmaatthh (button) folded on the Flop
Seat 7: Cooki2759 (small blind) showed [Tc Jd] and won (865) with two pair, Jacks and Eights
Seat 8: Luís Soeiro 28 (big blind) folded on the Turn
Seat 9: danilo141008 showed [6d 6h] and lost with two pair, Eights and Sixes



PokerStars Hand #201497230829: Tournament #2629783708, 8700+1300 Hold'em No Limit - Level II (15/30) - 2019/06/17 22:11:05 ET
Table '2629783708 14' 9-max Seat #7 is the button
Seat 2: Taargeett (1490 in chips) 
Seat 3: TheMasterStar (1400 in chips) 
Seat 4: KoKabul (1540 in chips) 
Seat 5: fritz664 (1820 in chips) 
Seat 6: TRISTAN10011 (4785 in chips) 
Seat 7: mjardimm (1235 in chips) is sitting out
Seat 8: ALERICO37 (1500 in chips) out of hand (moved from another table into small blind)
Seat 9: LZ1212 (1220 in chips) 
ALERICO37 will be allowed to play after the button
LZ1212: posts small blind 15
Taargeett: posts big blind 30
*** HOLE CARDS ***
Dealt to Taargeett [9h 7d]
TheMasterStar: calls 30
KoKabul: folds 
fritz664: calls 30
TRISTAN10011: folds 
mjardimm: folds 
LZ1212: calls 15
Taargeett has timed out
Taargeett: checks 
*** FLOP *** [6s Th 4h]
LZ1212: checks 
Taargeett: checks 
TheMasterStar: bets 60
fritz664: folds 
LZ1212: calls 60
Taargeett: folds 
*** TURN *** [6s Th 4h] [8c]
LZ1212: checks 
TheMasterStar: bets 240
LZ1212: folds 
Uncalled bet (240) returned to TheMasterStar
TheMasterStar collected 240 from pot
TheMasterStar: doesn't show hand 
*** SUMMARY ***
Total pot 240 | Rake 0 
Board [6s Th 4h 8c]
Seat 2: Taargeett (big blind) folded on the Flop
Seat 3: TheMasterStar collected (240)
Seat 4: KoKabul folded before Flop (didn't bet)
Seat 5: fritz664 folded on the Flop
Seat 6: TRISTAN10011 folded before Flop (didn't bet)
Seat 7: mjardimm (button) folded before Flop (didn't bet)
Seat 9: LZ1212 (small blind) folded on the Turn



PokerStars Hand #201497251717: Tournament #2629783708, 8700+1300 Hold'em No Limit - Level II (15/30) - 2019/06/17 22:12:30 ET
Table '2629783708 14' 9-max Seat #9 is the button
Seat 1: tiger2th (1500 in chips) out of hand (moved from another table into small blind)
Seat 2: Taargeett (1460 in chips) 
Seat 3: TheMasterStar (1550 in chips) 
Seat 4: KoKabul (1540 in chips) 
Seat 5: fritz664 (1790 in chips) 
Seat 6: TRISTAN10011 (4785 in chips) 
Seat 7: mjardimm (1235 in chips) is sitting out
Seat 8: ALERICO37 (1500 in chips) 
Seat 9: LZ1212 (1130 in chips) 
tiger2th will be allowed to play after the button
Taargeett: posts small blind 15
TheMasterStar: posts big blind 30
*** HOLE CARDS ***
Dealt to Taargeett [3s 4c]
KoKabul: folds 
fritz664: raises 30 to 60
TRISTAN10011: folds 
mjardimm: calls 60
ALERICO37: calls 60
LZ1212: calls 60
Taargeett: folds 
TheMasterStar: raises 315 to 375
fritz664: raises 1415 to 1790 and is all-in
mjardimm: calls 1175 and is all-in
ALERICO37: folds 
LZ1212: folds 
TheMasterStar: calls 1175 and is all-in
Uncalled bet (240) returned to fritz664
*** FLOP *** [Kd 8s 6h]
*** TURN *** [Kd 8s 6h] [7s]
*** RIVER *** [Kd 8s 6h 7s] [6s]
*** SHOW DOWN ***
TheMasterStar: shows [Ac Qh] (a pair of Sixes)
fritz664: shows [5d 5c] (two pair, Sixes and Fives)
fritz664 collected 630 from side pot
mjardimm: shows [Ah Th] (a pair of Sixes)
fritz664 collected 3840 from main pot
TheMasterStar finished the tournament
mjardimm finished the tournament
*** SUMMARY ***
Total pot 4470 Main pot 3840. Side pot 630. | Rake 0 
Board [Kd 8s 6h 7s 6s]
Seat 2: Taargeett (small blind) folded before Flop
Seat 3: TheMasterStar (big blind) showed [Ac Qh] and lost with a pair of Sixes
Seat 4: KoKabul folded before Flop (didn't bet)
Seat 5: fritz664 showed [5d 5c] and won (4470) with two pair, Sixes and Fives
Seat 6: TRISTAN10011 folded before Flop (didn't bet)
Seat 7: mjardimm showed [Ah Th] and lost with a pair of Sixes
Seat 8: ALERICO37 folded before Flop
Seat 9: LZ1212 (button) folded before Flop



PokerStars Hand #201497266899: Tournament #2629783708, 8700+1300 Hold'em No Limit - Level II (15/30) - 2019/06/17 22:13:32 ET
Table '2629783708 14' 9-max Seat #2 is the button
Seat 1: tiger2th (1500 in chips) 
Seat 2: Taargeett (1445 in chips) 
Seat 3: laztony (1470 in chips) out of hand (moved from another table into small blind)
Seat 4: KoKabul (1540 in chips) 
Seat 5: fritz664 (4710 in chips) 
Seat 6: TRISTAN10011 (4785 in chips) 
Seat 8: ALERICO37 (1440 in chips) 
Seat 9: LZ1212 (1070 in chips) 
laztony will be allowed to play after the button
KoKabul: posts small blind 15
fritz664: posts big blind 30
*** HOLE CARDS ***
Dealt to Taargeett [Kc Js]
TRISTAN10011 has timed out
TRISTAN10011: folds 
ALERICO37: folds 
LZ1212: calls 30
tiger2th: folds 
Taargeett: raises 60 to 90
KoKabul: folds 
fritz664: folds 
LZ1212: calls 60
*** FLOP *** [As Ts 8s]
LZ1212: checks 
Taargeett: bets 225
LZ1212: calls 225
*** TURN *** [As Ts 8s] [Jc]
LZ1212: checks 
Taargeett: bets 675
LZ1212: raises 80 to 755 and is all-in
Taargeett: calls 80
*** RIVER *** [As Ts 8s Jc] [Qh]
*** SHOW DOWN ***
LZ1212: shows [Kh Jh] (a straight, Ten to Ace)
Taargeett: shows [Kc Js] (a straight, Ten to Ace)
LZ1212 collected 1093 from pot
Taargeett collected 1092 from pot
*** SUMMARY ***
Total pot 2185 | Rake 0 
Board [As Ts 8s Jc Qh]
Seat 1: tiger2th folded before Flop (didn't bet)
Seat 2: Taargeett (button) showed [Kc Js] and won (1092) with a straight, Ten to Ace
Seat 4: KoKabul (small blind) folded before Flop
Seat 5: fritz664 (big blind) folded before Flop
Seat 6: TRISTAN10011 folded before Flop (didn't bet)
Seat 8: ALERICO37 folded before Flop (didn't bet)
Seat 9: LZ1212 showed [Kh Jh] and won (1093) with a straight, Ten to Ace



PokerStars Hand #201497285796: Tournament #2629783708, 8700+1300 Hold'em No Limit - Level II (15/30) - 2019/06/17 22:14:48 ET
Table '2629783708 14' 9-max Seat #4 is the button
Seat 1: tiger2th (1500 in chips) 
Seat 2: Taargeett (1467 in chips) 
Seat 3: laztony (1470 in chips) 
Seat 4: KoKabul (1525 in chips) 
Seat 5: fritz664 (4680 in chips) 
Seat 6: TRISTAN10011 (4785 in chips) 
Seat 7: Entoptic (1500 in chips) 
Seat 8: ALERICO37 (1440 in chips) 
Seat 9: LZ1212 (1093 in chips) 
fritz664: posts small blind 15
TRISTAN10011: posts big blind 30
*** HOLE CARDS ***
Dealt to Taargeett [Jh 9d]
Entoptic: folds 
ALERICO37: folds 
LZ1212: folds 
tiger2th: calls 30
Taargeett has timed out
Taargeett: folds 
laztony: folds 
KoKabul: raises 105 to 135
fritz664: calls 120
TRISTAN10011: folds 
tiger2th: folds 
*** FLOP *** [7s Qs Th]
fritz664: checks 
KoKabul: bets 120
fritz664: calls 120
*** TURN *** [7s Qs Th] [4c]
fritz664: checks 
KoKabul: checks 
*** RIVER *** [7s Qs Th 4c] [Qc]
fritz664: bets 570
KoKabul: folds 
Uncalled bet (570) returned to fritz664
fritz664 collected 570 from pot
fritz664: doesn't show hand 
*** SUMMARY ***
Total pot 570 | Rake 0 
Board [7s Qs Th 4c Qc]
Seat 1: tiger2th folded before Flop
Seat 2: Taargeett folded before Flop (didn't bet)
Seat 3: laztony folded before Flop (didn't bet)
Seat 4: KoKabul (button) folded on the River
Seat 5: fritz664 (small blind) collected (570)
Seat 6: TRISTAN10011 (big blind) folded before Flop
Seat 7: Entoptic folded before Flop (didn't bet)
Seat 8: ALERICO37 folded before Flop (didn't bet)
Seat 9: LZ1212 folded before Flop (didn't bet)



PokerStars Hand #201497306401: Tournament #2629783708, 8700+1300 Hold'em No Limit - Level III (25/50) - 2019/06/17 22:16:12 ET
Table '2629783708 14' 9-max Seat #5 is the button
Seat 1: tiger2th (1470 in chips) 
Seat 2: Taargeett (1467 in chips) 
Seat 3: laztony (1470 in chips) 
Seat 4: KoKabul (1270 in chips) 
Seat 5: fritz664 (4995 in chips) 
Seat 6: TRISTAN10011 (4755 in chips) 
Seat 7: Entoptic (1500 in chips) 
Seat 8: ALERICO37 (1440 in chips) 
Seat 9: LZ1212 (1093 in chips) 
TRISTAN10011: posts small blind 25
Entoptic: posts big blind 50
*** HOLE CARDS ***
Dealt to Taargeett [3d Qs]
ALERICO37: raises 150 to 200
LZ1212: folds 
tiger2th: folds 
Taargeett: folds 
laztony: folds 
KoKabul: folds 
fritz664: raises 475 to 675
TRISTAN10011: folds 
Entoptic: folds 
ALERICO37: raises 765 to 1440 and is all-in
fritz664: calls 765
*** FLOP *** [4h 6d Js]
*** TURN *** [4h 6d Js] [6h]
*** RIVER *** [4h 6d Js 6h] [Ah]
*** SHOW DOWN ***
ALERICO37: shows [As Ad] (a full house, Aces full of Sixes)
fritz664: shows [Qc Ac] (two pair, Aces and Sixes)
ALERICO37 collected 2955 from pot
*** SUMMARY ***
Total pot 2955 | Rake 0 
Board [4h 6d Js 6h Ah]
Seat 1: tiger2th folded before Flop (didn't bet)
Seat 2: Taargeett folded before Flop (didn't bet)
Seat 3: laztony folded before Flop (didn't bet)
Seat 4: KoKabul folded before Flop (didn't bet)
Seat 5: fritz664 (button) showed [Qc Ac] and lost with two pair, Aces and Sixes
Seat 6: TRISTAN10011 (small blind) folded before Flop
Seat 7: Entoptic (big blind) folded before Flop
Seat 8: ALERICO37 showed [As Ad] and won (2955) with a full house, Aces full of Sixes
Seat 9: LZ1212 folded before Flop (didn't bet)



PokerStars Hand #201497315172: Tournament #2629783708, 8700+1300 Hold'em No Limit - Level III (25/50) - 2019/06/17 22:16:47 ET
Table '2629783708 14' 9-max Seat #6 is the button
Seat 1: tiger2th (1470 in chips) 
Seat 2: Taargeett (1467 in chips) 
Seat 3: laztony (1470 in chips) 
Seat 4: KoKabul (1270 in chips) 
Seat 5: fritz664 (3555 in chips) 
Seat 6: TRISTAN10011 (4730 in chips) 
Seat 7: Entoptic (1450 in chips) 
Seat 8: ALERICO37 (2955 in chips) 
Seat 9: LZ1212 (1093 in chips) 
Entoptic: posts small blind 25
ALERICO37: posts big blind 50
*** HOLE CARDS ***
Dealt to Taargeett [9s Ts]
LZ1212: calls 50
tiger2th: calls 50
Taargeett: raises 50 to 100
laztony: folds 
KoKabul: folds 
fritz664: folds 
TRISTAN10011: folds 
Entoptic: calls 75
ALERICO37: calls 50
LZ1212: calls 50
tiger2th: calls 50
*** FLOP *** [Ah 6s 8s]
Entoptic: checks 
ALERICO37: bets 100
LZ1212: calls 100
tiger2th: calls 100
Taargeett: calls 100
Entoptic: folds 
*** TURN *** [Ah 6s 8s] [7h]
ALERICO37: bets 450
LZ1212: folds 
tiger2th: calls 450
Taargeett: raises 817 to 1267 and is all-in
ALERICO37: calls 817
tiger2th: folds 
*** RIVER *** [Ah 6s 8s 7h] [Qs]
*** SHOW DOWN ***
ALERICO37: shows [Ad Js] (a pair of Aces)
Taargeett: shows [9s Ts] (a flush, Queen high)
Taargeett collected 3884 from pot
*** SUMMARY ***
Total pot 3884 | Rake 0 
Board [Ah 6s 8s 7h Qs]
Seat 1: tiger2th folded on the Turn
Seat 2: Taargeett showed [9s Ts] and won (3884) with a flush, Queen high
Seat 3: laztony folded before Flop (didn't bet)
Seat 4: KoKabul folded before Flop (didn't bet)
Seat 5: fritz664 folded before Flop (didn't bet)
Seat 6: TRISTAN10011 (button) folded before Flop (didn't bet)
Seat 7: Entoptic (small blind) folded on the Flop
Seat 8: ALERICO37 (big blind) showed [Ad Js] and lost with a pair of Aces
Seat 9: LZ1212 folded on the Turn



PokerStars Hand #201497335040: Tournament #2629783708, 8700+1300 Hold'em No Limit - Level III (25/50) - 2019/06/17 22:18:07 ET
Table '2629783708 14' 9-max Seat #7 is the button
Seat 1: tiger2th (820 in chips) 
Seat 2: Taargeett (3884 in chips) 
Seat 3: laztony (1470 in chips) 
Seat 4: KoKabul (1270 in chips) 
Seat 5: fritz664 (3555 in chips) 
Seat 6: TRISTAN10011 (4730 in chips) 
Seat 7: Entoptic (1350 in chips) 
Seat 8: ALERICO37 (1488 in chips) 
Seat 9: LZ1212 (893 in chips) 
ALERICO37: posts small blind 25
LZ1212: posts big blind 50
*** HOLE CARDS ***
Dealt to Taargeett [5h 6h]
tiger2th: calls 50
Taargeett: folds 
laztony: folds 
KoKabul: calls 50
fritz664: raises 3505 to 3555 and is all-in
TRISTAN10011: folds 
Entoptic: folds 
ALERICO37: folds 
LZ1212: folds 
tiger2th: folds 
KoKabul: folds 
Uncalled bet (3505) returned to fritz664
fritz664 collected 225 from pot
*** SUMMARY ***
Total pot 225 | Rake 0 
Seat 1: tiger2th folded before Flop
Seat 2: Taargeett folded before Flop (didn't bet)
Seat 3: laztony folded before Flop (didn't bet)
Seat 4: KoKabul folded before Flop
Seat 5: fritz664 collected (225)
Seat 6: TRISTAN10011 folded before Flop (didn't bet)
Seat 7: Entoptic (button) folded before Flop (didn't bet)
Seat 8: ALERICO37 (small blind) folded before Flop
Seat 9: LZ1212 (big blind) folded before Flop



PokerStars Hand #201497345884: Tournament #2629783708, 8700+1300 Hold'em No Limit - Level III (25/50) - 2019/06/17 22:18:52 ET
Table '2629783708 14' 9-max Seat #8 is the button
Seat 1: tiger2th (770 in chips) 
Seat 2: Taargeett (3884 in chips) 
Seat 3: laztony (1470 in chips) 
Seat 4: KoKabul (1220 in chips) 
Seat 5: fritz664 (3730 in chips) 
Seat 6: TRISTAN10011 (4730 in chips) 
Seat 7: Entoptic (1350 in chips) 
Seat 8: ALERICO37 (1463 in chips) 
Seat 9: LZ1212 (843 in chips) 
LZ1212: posts small blind 25
tiger2th: posts big blind 50
*** HOLE CARDS ***
Dealt to Taargeett [3c 5s]
Taargeett: folds 
laztony: calls 50
KoKabul: folds 
fritz664: calls 50
TRISTAN10011: calls 50
Entoptic: raises 50 to 100
ALERICO37: raises 1363 to 1463 and is all-in
LZ1212: calls 818 and is all-in
tiger2th: folds 
laztony: folds 
fritz664: calls 1413
TRISTAN10011: calls 1413
Entoptic: calls 1250 and is all-in
*** FLOP *** [2c 3h 9d]
fritz664: checks 
TRISTAN10011: checks 
*** TURN *** [2c 3h 9d] [Td]
fritz664: checks 
TRISTAN10011: checks 
*** RIVER *** [2c 3h 9d Td] [Kd]
fritz664: checks 
TRISTAN10011: checks 
*** SHOW DOWN ***
fritz664: shows [7c 8c] (high card King)
TRISTAN10011: shows [5d 5c] (a pair of Fives)
ALERICO37: mucks hand 
TRISTAN10011 collected 339 from side pot-2 
Entoptic: shows [Qc Tc] (a pair of Tens)
Entoptic collected 2028 from side pot-1 
LZ1212: shows [Ks 8s] (a pair of Kings)
LZ1212 collected 4315 from main pot
ALERICO37 finished the tournament
*** SUMMARY ***
Total pot 6682 Main pot 4315. Side pot-1 2028. Side pot-2 339. | Rake 0 
Board [2c 3h 9d Td Kd]
Seat 1: tiger2th (big blind) folded before Flop
Seat 2: Taargeett folded before Flop (didn't bet)
Seat 3: laztony folded before Flop
Seat 4: KoKabul folded before Flop (didn't bet)
Seat 5: fritz664 showed [7c 8c] and lost with high card King
Seat 6: TRISTAN10011 showed [5d 5c] and won (339) with a pair of Fives
Seat 7: Entoptic showed [Qc Tc] and won (2028) with a pair of Tens
Seat 8: ALERICO37 (button) mucked [Ad Jc]
Seat 9: LZ1212 (small blind) showed [Ks 8s] and won (4315) with a pair of Kings



PokerStars Hand #201497366743: Tournament #2629783708, 8700+1300 Hold'em No Limit - Level IV (50/100) - 2019/06/17 22:20:17 ET
Table '2629783708 14' 9-max Seat #9 is the button
Seat 1: tiger2th (720 in chips) 
Seat 2: Taargeett (3884 in chips) 
Seat 3: laztony (1420 in chips) 
Seat 4: KoKabul (1220 in chips) 
Seat 5: fritz664 (2267 in chips) 
Seat 6: TRISTAN10011 (3606 in chips) 
Seat 7: Entoptic (2028 in chips) 
Seat 9: LZ1212 (4315 in chips) 
tiger2th: posts small blind 50
Taargeett: posts big blind 100
*** HOLE CARDS ***
Dealt to Taargeett [8h 9h]
laztony: folds 
KoKabul: folds 
fritz664: raises 2167 to 2267 and is all-in
TRISTAN10011: folds 
Entoptic: folds 
LZ1212: folds 
tiger2th: folds 
Taargeett: folds 
Uncalled bet (2167) returned to fritz664
fritz664 collected 250 from pot
*** SUMMARY ***
Total pot 250 | Rake 0 
Seat 1: tiger2th (small blind) folded before Flop
Seat 2: Taargeett (big blind) folded before Flop
Seat 3: laztony folded before Flop (didn't bet)
Seat 4: KoKabul folded before Flop (didn't bet)
Seat 5: fritz664 collected (250)
Seat 6: TRISTAN10011 folded before Flop (didn't bet)
Seat 7: Entoptic folded before Flop (didn't bet)
Seat 9: LZ1212 (button) folded before Flop (didn't bet)



PokerStars Hand #201497373481: Tournament #2629783708, 8700+1300 Hold'em No Limit - Level IV (50/100) - 2019/06/17 22:20:44 ET
Table '2629783708 14' 9-max Seat #1 is the button
Seat 1: tiger2th (670 in chips) 
Seat 2: Taargeett (3784 in chips) 
Seat 3: laztony (1420 in chips) 
Seat 4: KoKabul (1220 in chips) 
Seat 5: fritz664 (2417 in chips) 
Seat 6: TRISTAN10011 (3606 in chips) 
Seat 7: Entoptic (2028 in chips) 
Seat 9: LZ1212 (4315 in chips) 
Taargeett: posts small blind 50
laztony: posts big blind 100
*** HOLE CARDS ***
Dealt to Taargeett [5c 5d]
KoKabul: folds 
fritz664: folds 
TRISTAN10011: raises 200 to 300
Entoptic: folds 
LZ1212: folds 
tiger2th: folds 
Taargeett: folds 
laztony: folds 
Uncalled bet (200) returned to TRISTAN10011
TRISTAN10011 collected 250 from pot
TRISTAN10011: doesn't show hand 
*** SUMMARY ***
Total pot 250 | Rake 0 
Seat 1: tiger2th (button) folded before Flop (didn't bet)
Seat 2: Taargeett (small blind) folded before Flop
Seat 3: laztony (big blind) folded before Flop
Seat 4: KoKabul folded before Flop (didn't bet)
Seat 5: fritz664 folded before Flop (didn't bet)
Seat 6: TRISTAN10011 collected (250)
Seat 7: Entoptic folded before Flop (didn't bet)
Seat 9: LZ1212 folded before Flop (didn't bet)



PokerStars Hand #201497381770: Tournament #2629783708, 8700+1300 Hold'em No Limit - Level IV (50/100) - 2019/06/17 22:21:19 ET
Table '2629783708 14' 9-max Seat #2 is the button
Seat 1: tiger2th (670 in chips) 
Seat 2: Taargeett (3734 in chips) 
Seat 3: laztony (1320 in chips) 
Seat 4: KoKabul (1220 in chips) 
Seat 5: fritz664 (2417 in chips) 
Seat 6: TRISTAN10011 (3756 in chips) 
Seat 7: Entoptic (2028 in chips) 
Seat 9: LZ1212 (4315 in chips) 
laztony: posts small blind 50
KoKabul: posts big blind 100
*** HOLE CARDS ***
Dealt to Taargeett [5h 5s]
fritz664: folds 
TRISTAN10011: folds 
Entoptic: raises 200 to 300
LZ1212: folds 
tiger2th: folds 
Taargeett: folds 
laztony: calls 250
KoKabul: folds 
*** FLOP *** [2d 9d Qs]
laztony: checks 
Entoptic: bets 700
laztony: folds 
Uncalled bet (700) returned to Entoptic
Entoptic collected 700 from pot
Entoptic: doesn't show hand 
*** SUMMARY ***
Total pot 700 | Rake 0 
Board [2d 9d Qs]
Seat 1: tiger2th folded before Flop (didn't bet)
Seat 2: Taargeett (button) folded before Flop (didn't bet)
Seat 3: laztony (small blind) folded on the Flop
Seat 4: KoKabul (big blind) folded before Flop
Seat 5: fritz664 folded before Flop (didn't bet)
Seat 6: TRISTAN10011 folded before Flop (didn't bet)
Seat 7: Entoptic collected (700)
Seat 9: LZ1212 folded before Flop (didn't bet)



PokerStars Hand #201497391023: Tournament #2629783708, 8700+1300 Hold'em No Limit - Level IV (50/100) - 2019/06/17 22:21:57 ET
Table '2629783708 14' 9-max Seat #3 is the button
Seat 1: tiger2th (670 in chips) 
Seat 2: Taargeett (3734 in chips) 
Seat 3: laztony (1020 in chips) 
Seat 4: KoKabul (1120 in chips) 
Seat 5: fritz664 (2417 in chips) 
Seat 6: TRISTAN10011 (3756 in chips) 
Seat 7: Entoptic (2428 in chips) 
Seat 9: LZ1212 (4315 in chips) 
KoKabul: posts small blind 50
fritz664: posts big blind 100
*** HOLE CARDS ***
Dealt to Taargeett [Ac 9h]
TRISTAN10011: folds 
Entoptic: folds 
LZ1212: calls 100
tiger2th: calls 100
Taargeett: raises 100 to 200
laztony: calls 200
KoKabul: folds 
fritz664: folds 
LZ1212: calls 100
tiger2th: calls 100
*** FLOP *** [7c Th 4c]
LZ1212: checks 
tiger2th: checks 
Taargeett: checks 
laztony: checks 
*** TURN *** [7c Th 4c] [7d]
LZ1212: checks 
tiger2th: checks 
Taargeett: bets 200
laztony: calls 200
LZ1212 has timed out
LZ1212: folds 
tiger2th: folds 
*** RIVER *** [7c Th 4c 7d] [9c]
Taargeett: bets 1350
laztony: folds 
Uncalled bet (1350) returned to Taargeett
Taargeett collected 1350 from pot
Taargeett: doesn't show hand 
*** SUMMARY ***
Total pot 1350 | Rake 0 
Board [7c Th 4c 7d 9c]
Seat 1: tiger2th folded on the Turn
Seat 2: Taargeett collected (1350)
Seat 3: laztony (button) folded on the River
Seat 4: KoKabul (small blind) folded before Flop
Seat 5: fritz664 (big blind) folded before Flop
Seat 6: TRISTAN10011 folded before Flop (didn't bet)
Seat 7: Entoptic folded before Flop (didn't bet)
Seat 9: LZ1212 folded on the Turn



PokerStars Hand #201497413878: Tournament #2629783708, 8700+1300 Hold'em No Limit - Level IV (50/100) - 2019/06/17 22:23:31 ET
Table '2629783708 14' 9-max Seat #4 is the button
Seat 1: tiger2th (470 in chips) 
Seat 2: Taargeett (4684 in chips) 
Seat 3: laztony (620 in chips) 
Seat 4: KoKabul (1070 in chips) 
Seat 5: fritz664 (2317 in chips) 
Seat 6: TRISTAN10011 (3756 in chips) 
Seat 7: Entoptic (2428 in chips) 
Seat 8: frusciante666 (1500 in chips) 
Seat 9: LZ1212 (4115 in chips) is sitting out
fritz664: posts small blind 50
TRISTAN10011: posts big blind 100
*** HOLE CARDS ***
Dealt to Taargeett [Js Th]
Entoptic: folds 
frusciante666: folds 
LZ1212: folds 
tiger2th: calls 100
Taargeett: folds 
laztony: calls 100
KoKabul: calls 100
fritz664: folds 
TRISTAN10011: checks 
*** FLOP *** [Tc 9s 9d]
TRISTAN10011: checks 
tiger2th: bets 100
laztony: calls 100
KoKabul: folds 
TRISTAN10011: folds 
*** TURN *** [Tc 9s 9d] [3h]
tiger2th: bets 100
laztony: calls 100
*** RIVER *** [Tc 9s 9d 3h] [As]
tiger2th: bets 170 and is all-in
laztony: calls 170
*** SHOW DOWN ***
tiger2th: shows [Ac Ad] (a full house, Aces full of Nines)
laztony: shows [8d Ah] (two pair, Aces and Nines)
tiger2th collected 1190 from pot
*** SUMMARY ***
Total pot 1190 | Rake 0 
Board [Tc 9s 9d 3h As]
Seat 1: tiger2th showed [Ac Ad] and won (1190) with a full house, Aces full of Nines
Seat 2: Taargeett folded before Flop (didn't bet)
Seat 3: laztony showed [8d Ah] and lost with two pair, Aces and Nines
Seat 4: KoKabul (button) folded on the Flop
Seat 5: fritz664 (small blind) folded before Flop
Seat 6: TRISTAN10011 (big blind) folded on the Flop
Seat 7: Entoptic folded before Flop (didn't bet)
Seat 8: frusciante666 folded before Flop (didn't bet)
Seat 9: LZ1212 folded before Flop (didn't bet)



PokerStars Hand #201497426653: Tournament #2629783708, 8700+1300 Hold'em No Limit - Level IV (50/100) - 2019/06/17 22:24:24 ET
Table '2629783708 14' 9-max Seat #5 is the button
Seat 1: tiger2th (1190 in chips) 
Seat 2: Taargeett (4684 in chips) 
Seat 3: laztony (150 in chips) 
Seat 4: KoKabul (970 in chips) 
Seat 5: fritz664 (2267 in chips) 
Seat 6: TRISTAN10011 (3656 in chips) 
Seat 7: Entoptic (2428 in chips) 
Seat 8: frusciante666 (1500 in chips) 
Seat 9: LZ1212 (4115 in chips) 
TRISTAN10011: posts small blind 50
Entoptic: posts big blind 100
*** HOLE CARDS ***
Dealt to Taargeett [3h 4d]
frusciante666: calls 100
LZ1212: calls 100
tiger2th: calls 100
Taargeett: folds 
laztony: folds 
KoKabul: folds 
fritz664: folds 
TRISTAN10011: folds 
Entoptic: checks 
*** FLOP *** [6s 8d 2h]
Entoptic: bets 100
frusciante666: calls 100
LZ1212: folds 
tiger2th: calls 100
*** TURN *** [6s 8d 2h] [5c]
Entoptic: checks 
frusciante666: checks 
tiger2th: checks 
*** RIVER *** [6s 8d 2h 5c] [2s]
Entoptic: checks 
frusciante666: bets 800
tiger2th: folds 
Entoptic: folds 
Uncalled bet (800) returned to frusciante666
frusciante666 collected 750 from pot
frusciante666: doesn't show hand 
*** SUMMARY ***
Total pot 750 | Rake 0 
Board [6s 8d 2h 5c 2s]
Seat 1: tiger2th folded on the River
Seat 2: Taargeett folded before Flop (didn't bet)
Seat 3: laztony folded before Flop (didn't bet)
Seat 4: KoKabul folded before Flop (didn't bet)
Seat 5: fritz664 (button) folded before Flop (didn't bet)
Seat 6: TRISTAN10011 (small blind) folded before Flop
Seat 7: Entoptic (big blind) folded on the River
Seat 8: frusciante666 collected (750)
Seat 9: LZ1212 folded on the Flop



PokerStars Hand #201497444345: Tournament #2629783708, 8700+1300 Hold'em No Limit - Level V (75/150) - 2019/06/17 22:25:37 ET
Table '2629783708 14' 9-max Seat #6 is the button
Seat 1: tiger2th (990 in chips) 
Seat 2: Taargeett (4684 in chips) 
Seat 3: laztony (150 in chips) 
Seat 4: KoKabul (970 in chips) 
Seat 5: fritz664 (2267 in chips) 
Seat 6: TRISTAN10011 (3606 in chips) 
Seat 7: Entoptic (2228 in chips) 
Seat 8: frusciante666 (2050 in chips) 
Seat 9: LZ1212 (4015 in chips) 
Entoptic: posts small blind 75
frusciante666: posts big blind 150
*** HOLE CARDS ***
Dealt to Taargeett [9d 9s]
LZ1212 has timed out
LZ1212: folds 
tiger2th: folds 
Taargeett: raises 300 to 450
laztony: folds 
KoKabul: folds 
fritz664: raises 1817 to 2267 and is all-in
TRISTAN10011: folds 
Entoptic: folds 
frusciante666: folds 
Taargeett: folds 
Uncalled bet (1817) returned to fritz664
fritz664 collected 1125 from pot
*** SUMMARY ***
Total pot 1125 | Rake 0 
Seat 1: tiger2th folded before Flop (didn't bet)
Seat 2: Taargeett folded before Flop
Seat 3: laztony folded before Flop (didn't bet)
Seat 4: KoKabul folded before Flop (didn't bet)
Seat 5: fritz664 collected (1125)
Seat 6: TRISTAN10011 (button) folded before Flop (didn't bet)
Seat 7: Entoptic (small blind) folded before Flop
Seat 8: frusciante666 (big blind) folded before Flop
Seat 9: LZ1212 folded before Flop (didn't bet)



PokerStars Hand #201497455212: Tournament #2629783708, 8700+1300 Hold'em No Limit - Level V (75/150) - 2019/06/17 22:26:22 ET
Table '2629783708 14' 9-max Seat #7 is the button
Seat 1: tiger2th (990 in chips) 
Seat 2: Taargeett (4234 in chips) 
Seat 3: laztony (150 in chips) 
Seat 4: KoKabul (970 in chips) 
Seat 5: fritz664 (2942 in chips) 
Seat 6: TRISTAN10011 (3606 in chips) 
Seat 7: Entoptic (2153 in chips) 
Seat 8: frusciante666 (1900 in chips) 
Seat 9: LZ1212 (4015 in chips) is sitting out
frusciante666: posts small blind 75
LZ1212: posts big blind 150
*** HOLE CARDS ***
Dealt to Taargeett [3h 7c]
tiger2th: folds 
Taargeett: folds 
laztony: folds 
KoKabul: folds 
fritz664: folds 
TRISTAN10011: raises 150 to 300
Entoptic: folds 
frusciante666 has timed out
frusciante666: folds 
LZ1212: folds 
Uncalled bet (150) returned to TRISTAN10011
TRISTAN10011 collected 375 from pot
TRISTAN10011: doesn't show hand 
*** SUMMARY ***
Total pot 375 | Rake 0 
Seat 1: tiger2th folded before Flop (didn't bet)
Seat 2: Taargeett folded before Flop (didn't bet)
Seat 3: laztony folded before Flop (didn't bet)
Seat 4: KoKabul folded before Flop (didn't bet)
Seat 5: fritz664 folded before Flop (didn't bet)
Seat 6: TRISTAN10011 collected (375)
Seat 7: Entoptic (button) folded before Flop (didn't bet)
Seat 8: frusciante666 (small blind) folded before Flop
Seat 9: LZ1212 (big blind) folded before Flop



PokerStars Hand #201497473158: Tournament #2629783708, 8700+1300 Hold'em No Limit - Level V (75/150) - 2019/06/17 22:27:25 ET
Table '2629783708 14' 9-max Seat #8 is the button
Seat 1: tiger2th (990 in chips) 
Seat 2: Taargeett (4234 in chips) 
Seat 3: laztony (150 in chips) 
Seat 4: KoKabul (970 in chips) 
Seat 5: fritz664 (2942 in chips) 
Seat 6: TRISTAN10011 (3831 in chips) 
Seat 7: Entoptic (2153 in chips) 
Seat 8: frusciante666 (1825 in chips) is sitting out
Seat 9: LZ1212 (3865 in chips) is sitting out
LZ1212: posts small blind 75
tiger2th: posts big blind 150
*** HOLE CARDS ***
Dealt to Taargeett [6d 5s]
frusciante666 is disconnected 
Taargeett: folds 
laztony: folds 
KoKabul: folds 
fritz664: folds 
TRISTAN10011: folds 
Entoptic: calls 150
frusciante666: folds 
LZ1212: folds 
tiger2th: checks 
*** FLOP *** [Kd 3h Th]
tiger2th: checks 
Entoptic: bets 150
tiger2th: folds 
Uncalled bet (150) returned to Entoptic
Entoptic collected 375 from pot
Entoptic: doesn't show hand 
*** SUMMARY ***
Total pot 375 | Rake 0 
Board [Kd 3h Th]
Seat 1: tiger2th (big blind) folded on the Flop
Seat 2: Taargeett folded before Flop (didn't bet)
Seat 3: laztony folded before Flop (didn't bet)
Seat 4: KoKabul folded before Flop (didn't bet)
Seat 5: fritz664 folded before Flop (didn't bet)
Seat 6: TRISTAN10011 folded before Flop (didn't bet)
Seat 7: Entoptic collected (375)
Seat 8: frusciante666 (button) folded before Flop (didn't bet)
Seat 9: LZ1212 (small blind) folded before Flop



PokerStars Hand #201497484015: Tournament #2629783708, 8700+1300 Hold'em No Limit - Level V (75/150) - 2019/06/17 22:28:11 ET
Table '2629783708 14' 9-max Seat #9 is the button
Seat 1: tiger2th (840 in chips) 
Seat 2: Taargeett (4234 in chips) 
Seat 3: laztony (150 in chips) 
Seat 4: KoKabul (970 in chips) 
Seat 5: fritz664 (2942 in chips) 
Seat 6: TRISTAN10011 (3831 in chips) 
Seat 8: frusciante666 (1825 in chips) is sitting out
Seat 9: LZ1212 (3790 in chips) is sitting out
tiger2th: posts small blind 75
Taargeett: posts big blind 150
*** HOLE CARDS ***
Dealt to Taargeett [7d Qs]
laztony: folds 
KoKabul: folds 
fritz664: folds 
TRISTAN10011: folds 
frusciante666: folds 
LZ1212: folds 
tiger2th: folds 
Uncalled bet (75) returned to Taargeett
Taargeett collected 150 from pot
Taargeett: doesn't show hand 
*** SUMMARY ***
Total pot 150 | Rake 0 
Seat 1: tiger2th (small blind) folded before Flop
Seat 2: Taargeett (big blind) collected (150)
Seat 3: laztony folded before Flop (didn't bet)
Seat 4: KoKabul folded before Flop (didn't bet)
Seat 5: fritz664 folded before Flop (didn't bet)
Seat 6: TRISTAN10011 folded before Flop (didn't bet)
Seat 8: frusciante666 folded before Flop (didn't bet)
Seat 9: LZ1212 (button) folded before Flop (didn't bet)



PokerStars Hand #201497487547: Tournament #2629783708, 8700+1300 Hold'em No Limit - Level V (75/150) - 2019/06/17 22:28:26 ET
Table '2629783708 14' 9-max Seat #1 is the button
Seat 1: tiger2th (765 in chips) 
Seat 2: Taargeett (4309 in chips) 
Seat 3: laztony (150 in chips) 
Seat 4: KoKabul (970 in chips) 
Seat 5: fritz664 (2942 in chips) 
Seat 6: TRISTAN10011 (3831 in chips) 
Seat 8: frusciante666 (1825 in chips) is sitting out
Seat 9: LZ1212 (3790 in chips) is sitting out
Taargeett: posts small blind 75
laztony: posts big blind 150 and is all-in
*** HOLE CARDS ***
Dealt to Taargeett [8h 4h]
KoKabul: folds 
fritz664: folds 
TRISTAN10011: raises 300 to 450
frusciante666: folds 
LZ1212: folds 
tiger2th: folds 
Taargeett: folds 
Uncalled bet (300) returned to TRISTAN10011
*** FLOP *** [Ah 7h 7c]
*** TURN *** [Ah 7h 7c] [Qc]
*** RIVER *** [Ah 7h 7c Qc] [8s]
*** SHOW DOWN ***
laztony: shows [5h 4d] (a pair of Sevens)
TRISTAN10011: shows [Kc Qd] (two pair, Queens and Sevens)
TRISTAN10011 collected 375 from pot
laztony finished the tournament
*** SUMMARY ***
Total pot 375 | Rake 0 
Board [Ah 7h 7c Qc 8s]
Seat 1: tiger2th (button) folded before Flop (didn't bet)
Seat 2: Taargeett (small blind) folded before Flop
Seat 3: laztony (big blind) showed [5h 4d] and lost with a pair of Sevens
Seat 4: KoKabul folded before Flop (didn't bet)
Seat 5: fritz664 folded before Flop (didn't bet)
Seat 6: TRISTAN10011 showed [Kc Qd] and won (375) with two pair, Queens and Sevens
Seat 8: frusciante666 folded before Flop (didn't bet)
Seat 9: LZ1212 folded before Flop (didn't bet)



PokerStars Hand #201497494395: Tournament #2629783708, 8700+1300 Hold'em No Limit - Level V (75/150) - 2019/06/17 22:28:54 ET
Table '2629783708 14' 9-max Seat #2 is the button
Seat 1: tiger2th (765 in chips) 
Seat 2: Taargeett (4234 in chips) 
Seat 3: simonrainbow (1500 in chips) out of hand (moved from another table into small blind)
Seat 4: KoKabul (970 in chips) 
Seat 5: fritz664 (2942 in chips) 
Seat 6: TRISTAN10011 (4056 in chips) 
Seat 7: Dr McGregor (1500 in chips) 
Seat 8: frusciante666 (1825 in chips) 
Seat 9: LZ1212 (3790 in chips) is sitting out
simonrainbow will be allowed to play after the button
KoKabul: posts small blind 75
fritz664: posts big blind 150
*** HOLE CARDS ***
Dealt to Taargeett [9d Qd]
TRISTAN10011: folds 
Dr McGregor: calls 150
frusciante666: calls 150
LZ1212: folds 
tiger2th: calls 150
Taargeett: raises 300 to 450
KoKabul: folds 
fritz664: raises 2492 to 2942 and is all-in
Dr McGregor: folds 
frusciante666: folds 
tiger2th: calls 615 and is all-in
Taargeett: calls 2492
*** FLOP *** [3c 4h Qh]
*** TURN *** [3c 4h Qh] [4s]
*** RIVER *** [3c 4h Qh 4s] [3d]
*** SHOW DOWN ***
fritz664: shows [8c 2c] (two pair, Fours and Threes)
Taargeett: shows [9d Qd] (two pair, Queens and Fours)
Taargeett collected 4354 from side pot
tiger2th: shows [5d Ad] (two pair, Fours and Threes)
Taargeett collected 2670 from main pot
fritz664 finished the tournament
tiger2th finished the tournament
*** SUMMARY ***
Total pot 7024 Main pot 2670. Side pot 4354. | Rake 0 
Board [3c 4h Qh 4s 3d]
Seat 1: tiger2th showed [5d Ad] and lost with two pair, Fours and Threes
Seat 2: Taargeett (button) showed [9d Qd] and won (7024) with two pair, Queens and Fours
Seat 4: KoKabul (small blind) folded before Flop
Seat 5: fritz664 (big blind) showed [8c 2c] and lost with two pair, Fours and Threes
Seat 6: TRISTAN10011 folded before Flop (didn't bet)
Seat 7: Dr McGregor folded before Flop
Seat 8: frusciante666 folded before Flop
Seat 9: LZ1212 folded before Flop (didn't bet)



PokerStars Hand #201497503897: Tournament #2629783708, 8700+1300 Hold'em No Limit - Level V (75/150) - 2019/06/17 22:29:34 ET
Table '2629783708 14' 9-max Seat #4 is the button
Seat 1: catas1234925 (4810 in chips) 
Seat 2: Taargeett (8316 in chips) 
Seat 3: simonrainbow (1500 in chips) 
Seat 4: KoKabul (895 in chips) 
Seat 6: TRISTAN10011 (4056 in chips) 
Seat 7: Dr McGregor (1350 in chips) 
Seat 8: frusciante666 (1675 in chips) 
Seat 9: LZ1212 (3790 in chips) is sitting out
TRISTAN10011: posts small blind 75
Dr McGregor: posts big blind 150
*** HOLE CARDS ***
Dealt to Taargeett [3s Jc]
frusciante666: calls 150
LZ1212: folds 
catas1234925: folds 
Taargeett: folds 
simonrainbow: raises 300 to 450
KoKabul: folds 
TRISTAN10011: folds 
Dr McGregor: folds 
frusciante666: calls 300
*** FLOP *** [Kd Kc 6h]
frusciante666: checks 
simonrainbow: bets 750
frusciante666: folds 
Uncalled bet (750) returned to simonrainbow
simonrainbow collected 1125 from pot
*** SUMMARY ***
Total pot 1125 | Rake 0 
Board [Kd Kc 6h]
Seat 1: catas1234925 folded before Flop (didn't bet)
Seat 2: Taargeett folded before Flop (didn't bet)
Seat 3: simonrainbow collected (1125)
Seat 4: KoKabul (button) folded before Flop (didn't bet)
Seat 6: TRISTAN10011 (small blind) folded before Flop
Seat 7: Dr McGregor (big blind) folded before Flop
Seat 8: frusciante666 folded on the Flop
Seat 9: LZ1212 folded before Flop (didn't bet)



PokerStars Hand #201497511929: Tournament #2629783708, 8700+1300 Hold'em No Limit - Level VI (100/200) - 2019/06/17 22:30:08 ET
Table '2629783708 14' 9-max Seat #6 is the button
Seat 1: catas1234925 (4810 in chips) 
Seat 2: Taargeett (8316 in chips) 
Seat 3: simonrainbow (2175 in chips) 
Seat 4: KoKabul (895 in chips) 
Seat 5: leodani2 (1500 in chips) 
Seat 6: TRISTAN10011 (3981 in chips) 
Seat 7: Dr McGregor (1200 in chips) 
Seat 8: frusciante666 (1225 in chips) 
Seat 9: LZ1212 (3790 in chips) is sitting out
Dr McGregor: posts small blind 100
frusciante666: posts big blind 200
*** HOLE CARDS ***
Dealt to Taargeett [2h Jh]
LZ1212: folds 
catas1234925: folds 
Taargeett: raises 200 to 400
simonrainbow: folds 
KoKabul: calls 400
leodani2: folds 
TRISTAN10011: folds 
Dr McGregor: raises 800 to 1200 and is all-in
frusciante666: folds 
Taargeett: folds 
KoKabul: calls 495 and is all-in
Uncalled bet (305) returned to Dr McGregor
*** FLOP *** [6c 4d Ah]
*** TURN *** [6c 4d Ah] [Qc]
*** RIVER *** [6c 4d Ah Qc] [4c]
*** SHOW DOWN ***
Dr McGregor: shows [Kc Ad] (two pair, Aces and Fours)
KoKabul: shows [Qh Jc] (two pair, Queens and Fours)
Dr McGregor collected 2390 from pot
KoKabul finished the tournament
*** SUMMARY ***
Total pot 2390 | Rake 0 
Board [6c 4d Ah Qc 4c]
Seat 1: catas1234925 folded before Flop (didn't bet)
Seat 2: Taargeett folded before Flop
Seat 3: simonrainbow folded before Flop (didn't bet)
Seat 4: KoKabul showed [Qh Jc] and lost with two pair, Queens and Fours
Seat 5: leodani2 folded before Flop (didn't bet)
Seat 6: TRISTAN10011 (button) folded before Flop (didn't bet)
Seat 7: Dr McGregor (small blind) showed [Kc Ad] and won (2390) with two pair, Aces and Fours
Seat 8: frusciante666 (big blind) folded before Flop
Seat 9: LZ1212 folded before Flop (didn't bet)



PokerStars Hand #201497529565: Tournament #2629783708, 8700+1300 Hold'em No Limit - Level VI (100/200) - 2019/06/17 22:31:22 ET
Table '2629783708 14' 9-max Seat #7 is the button
Seat 1: catas1234925 (4810 in chips) 
Seat 2: Taargeett (7916 in chips) 
Seat 3: simonrainbow (2175 in chips) 
Seat 5: leodani2 (1500 in chips) 
Seat 6: TRISTAN10011 (3981 in chips) 
Seat 7: Dr McGregor (2695 in chips) 
Seat 8: frusciante666 (1025 in chips) 
Seat 9: LZ1212 (3790 in chips) is sitting out
frusciante666: posts small blind 100
LZ1212: posts big blind 200
*** HOLE CARDS ***
Dealt to Taargeett [Jd 4d]
catas1234925: folds 
Taargeett: folds 
simonrainbow: raises 200 to 400
leodani2: calls 400
TRISTAN10011: folds 
Dr McGregor: folds 
frusciante666: calls 300
LZ1212: folds 
*** FLOP *** [4s 3c 2h]
frusciante666: checks 
simonrainbow: bets 600
leodani2: folds 
frusciante666: folds 
Uncalled bet (600) returned to simonrainbow
simonrainbow collected 1400 from pot
*** SUMMARY ***
Total pot 1400 | Rake 0 
Board [4s 3c 2h]
Seat 1: catas1234925 folded before Flop (didn't bet)
Seat 2: Taargeett folded before Flop (didn't bet)
Seat 3: simonrainbow collected (1400)
Seat 5: leodani2 folded on the Flop
Seat 6: TRISTAN10011 folded before Flop (didn't bet)
Seat 7: Dr McGregor (button) folded before Flop (didn't bet)
Seat 8: frusciante666 (small blind) folded on the Flop
Seat 9: LZ1212 (big blind) folded before Flop



PokerStars Hand #201497538424: Tournament #2629783708, 8700+1300 Hold'em No Limit - Level VI (100/200) - 2019/06/17 22:32:00 ET
Table '2629783708 14' 9-max Seat #8 is the button
Seat 1: catas1234925 (4810 in chips) 
Seat 2: Taargeett (7916 in chips) 
Seat 3: simonrainbow (3175 in chips) 
Seat 5: leodani2 (1100 in chips) 
Seat 6: TRISTAN10011 (3981 in chips) 
Seat 7: Dr McGregor (2695 in chips) 
Seat 8: frusciante666 (625 in chips) 
Seat 9: LZ1212 (3590 in chips) is sitting out
LZ1212: posts small blind 100
catas1234925: posts big blind 200
*** HOLE CARDS ***
Dealt to Taargeett [9c 5c]
Taargeett: folds 
simonrainbow: folds 
leodani2: calls 200
TRISTAN10011: folds 
Dr McGregor: calls 200
frusciante666: raises 425 to 625 and is all-in
LZ1212: folds 
catas1234925: folds 
leodani2: calls 425
Dr McGregor: calls 425
*** FLOP *** [6h 9h 2s]
leodani2: checks 
Dr McGregor: checks 
*** TURN *** [6h 9h 2s] [6d]
leodani2: checks 
Dr McGregor: checks 
*** RIVER *** [6h 9h 2s 6d] [Js]
leodani2: checks 
Dr McGregor: checks 
*** SHOW DOWN ***
leodani2: shows [Qd Jh] (two pair, Jacks and Sixes)
Dr McGregor: mucks hand 
frusciante666: mucks hand 
leodani2 collected 2175 from pot
frusciante666 finished the tournament
*** SUMMARY ***
Total pot 2175 | Rake 0 
Board [6h 9h 2s 6d Js]
Seat 1: catas1234925 (big blind) folded before Flop
Seat 2: Taargeett folded before Flop (didn't bet)
Seat 3: simonrainbow folded before Flop (didn't bet)
Seat 5: leodani2 showed [Qd Jh] and won (2175) with two pair, Jacks and Sixes
Seat 6: TRISTAN10011 folded before Flop (didn't bet)
Seat 7: Dr McGregor mucked [Qc Td]
Seat 8: frusciante666 (button) mucked [3c 7c]
Seat 9: LZ1212 (small blind) folded before Flop



PokerStars Hand #201497551481: Tournament #2629783708, 8700+1300 Hold'em No Limit - Level VI (100/200) - 2019/06/17 22:32:56 ET
Table '2629783708 14' 9-max Seat #9 is the button
Seat 1: catas1234925 (4610 in chips) 
Seat 2: Taargeett (7916 in chips) 
Seat 3: simonrainbow (3175 in chips) 
Seat 4: GuidoG8 (2100 in chips) 
Seat 5: leodani2 (2650 in chips) 
Seat 6: TRISTAN10011 (3981 in chips) 
Seat 7: Dr McGregor (2070 in chips) 
Seat 9: LZ1212 (3490 in chips) is sitting out
catas1234925: posts small blind 100
Taargeett: posts big blind 200
*** HOLE CARDS ***
Dealt to Taargeett [Qc 4s]
simonrainbow: calls 200
GuidoG8: calls 200
leodani2: folds 
TRISTAN10011: raises 600 to 800
Dr McGregor: folds 
LZ1212: folds 
catas1234925: folds 
Taargeett: folds 
simonrainbow: calls 600
GuidoG8: folds 
*** FLOP *** [2s 6s Ad]
simonrainbow: checks 
TRISTAN10011: checks 
*** TURN *** [2s 6s Ad] [5c]
simonrainbow: bets 600
TRISTAN10011: folds 
Uncalled bet (600) returned to simonrainbow
simonrainbow collected 2100 from pot
*** SUMMARY ***
Total pot 2100 | Rake 0 
Board [2s 6s Ad 5c]
Seat 1: catas1234925 (small blind) folded before Flop
Seat 2: Taargeett (big blind) folded before Flop
Seat 3: simonrainbow collected (2100)
Seat 4: GuidoG8 folded before Flop
Seat 5: leodani2 folded before Flop (didn't bet)
Seat 6: TRISTAN10011 folded on the Turn
Seat 7: Dr McGregor folded before Flop (didn't bet)
Seat 9: LZ1212 (button) folded before Flop (didn't bet)



PokerStars Hand #201497566915: Tournament #2629783708, 8700+1300 Hold'em No Limit - Level VI (100/200) - 2019/06/17 22:34:03 ET
Table '2629783708 14' 9-max Seat #1 is the button
Seat 1: catas1234925 (4510 in chips) 
Seat 2: Taargeett (7716 in chips) 
Seat 3: simonrainbow (4475 in chips) 
Seat 4: GuidoG8 (1900 in chips) 
Seat 5: leodani2 (2650 in chips) 
Seat 6: TRISTAN10011 (3181 in chips) 
Seat 7: Dr McGregor (2070 in chips) 
Seat 8: ANG€L CARLOS (1500 in chips) 
Seat 9: LZ1212 (3490 in chips) is sitting out
Taargeett: posts small blind 100
simonrainbow: posts big blind 200
*** HOLE CARDS ***
Dealt to Taargeett [Kd 3s]
GuidoG8: folds 
leodani2: raises 400 to 600
TRISTAN10011: raises 2581 to 3181 and is all-in
Dr McGregor: folds 
ANG€L CARLOS: folds 
LZ1212: folds 
catas1234925: folds 
Taargeett: folds 
simonrainbow: folds 
leodani2: calls 2050 and is all-in
Uncalled bet (531) returned to TRISTAN10011
*** FLOP *** [Ad Kh 9d]
*** TURN *** [Ad Kh 9d] [2d]
*** RIVER *** [Ad Kh 9d 2d] [7h]
*** SHOW DOWN ***
leodani2: shows [Qc Qd] (a pair of Queens)
TRISTAN10011: shows [8h 8c] (a pair of Eights)
leodani2 collected 5600 from pot
*** SUMMARY ***
Total pot 5600 | Rake 0 
Board [Ad Kh 9d 2d 7h]
Seat 1: catas1234925 (button) folded before Flop (didn't bet)
Seat 2: Taargeett (small blind) folded before Flop
Seat 3: simonrainbow (big blind) folded before Flop
Seat 4: GuidoG8 folded before Flop (didn't bet)
Seat 5: leodani2 showed [Qc Qd] and won (5600) with a pair of Queens
Seat 6: TRISTAN10011 showed [8h 8c] and lost with a pair of Eights
Seat 7: Dr McGregor folded before Flop (didn't bet)
Seat 8: ANG€L CARLOS folded before Flop (didn't bet)
Seat 9: LZ1212 folded before Flop (didn't bet)



PokerStars Hand #201497574099: Tournament #2629783708, 8700+1300 Hold'em No Limit - Level VI (100/200) - 2019/06/17 22:34:34 ET
Table '2629783708 14' 9-max Seat #2 is the button
Seat 1: catas1234925 (4510 in chips) 
Seat 2: Taargeett (7616 in chips) 
Seat 3: simonrainbow (4275 in chips) 
Seat 4: GuidoG8 (1900 in chips) 
Seat 5: leodani2 (5600 in chips) 
Seat 6: TRISTAN10011 (531 in chips) 
Seat 7: Dr McGregor (2070 in chips) 
Seat 8: ANG€L CARLOS (1500 in chips) 
Seat 9: LZ1212 (3490 in chips) is sitting out
simonrainbow: posts small blind 100
GuidoG8: posts big blind 200
*** HOLE CARDS ***
Dealt to Taargeett [7d 4c]
leodani2 said, "ui...."
leodani2: folds 
TRISTAN10011: folds 
Dr McGregor: folds 
ANG€L CARLOS: folds 
LZ1212: folds 
catas1234925: folds 
Taargeett: folds 
simonrainbow: calls 100
GuidoG8: checks 
*** FLOP *** [8d 8c 4h]
simonrainbow: bets 267
GuidoG8: folds 
Uncalled bet (267) returned to simonrainbow
simonrainbow collected 400 from pot
*** SUMMARY ***
Total pot 400 | Rake 0 
Board [8d 8c 4h]
Seat 1: catas1234925 folded before Flop (didn't bet)
Seat 2: Taargeett (button) folded before Flop (didn't bet)
Seat 3: simonrainbow (small blind) collected (400)
Seat 4: GuidoG8 (big blind) folded on the Flop
Seat 5: leodani2 folded before Flop (didn't bet)
Seat 6: TRISTAN10011 folded before Flop (didn't bet)
Seat 7: Dr McGregor folded before Flop (didn't bet)
Seat 8: ANG€L CARLOS folded before Flop (didn't bet)
Seat 9: LZ1212 folded before Flop (didn't bet)



PokerStars Hand #201497580702: Tournament #2629783708, 8700+1300 Hold'em No Limit - Level VI (100/200) - 2019/06/17 22:35:02 ET
Table '2629783708 14' 9-max Seat #3 is the button
Seat 1: catas1234925 (4510 in chips) 
Seat 2: Taargeett (7616 in chips) 
Seat 3: simonrainbow (4475 in chips) 
Seat 4: GuidoG8 (1700 in chips) 
Seat 5: leodani2 (5600 in chips) 
Seat 6: TRISTAN10011 (531 in chips) 
Seat 7: Dr McGregor (2070 in chips) 
Seat 8: ANG€L CARLOS (1500 in chips) 
Seat 9: LZ1212 (3490 in chips) is sitting out
GuidoG8: posts small blind 100
leodani2: posts big blind 200
*** HOLE CARDS ***
Dealt to Taargeett [Js 8c]
TRISTAN10011: raises 331 to 531 and is all-in
Dr McGregor: folds 
ANG€L CARLOS: folds 
LZ1212: folds 
catas1234925: folds 
Taargeett: folds 
simonrainbow: folds 
GuidoG8: calls 431
leodani2: calls 331
*** FLOP *** [Th 7s 4s]
GuidoG8: bets 400
leodani2: calls 400
*** TURN *** [Th 7s 4s] [8s]
GuidoG8: bets 769 and is all-in
leodani2: calls 769
*** RIVER *** [Th 7s 4s 8s] [6d]
*** SHOW DOWN ***
GuidoG8: shows [4d Td] (two pair, Tens and Fours)
leodani2: shows [4h 5h] (a straight, Four to Eight)
leodani2 collected 2338 from side pot
TRISTAN10011: shows [Jc Ah] (high card Ace)
leodani2 collected 1593 from main pot
GuidoG8 finished the tournament in 245th place
TRISTAN10011 finished the tournament in 246th place
*** SUMMARY ***
Total pot 3931 Main pot 1593. Side pot 2338. | Rake 0 
Board [Th 7s 4s 8s 6d]
Seat 1: catas1234925 folded before Flop (didn't bet)
Seat 2: Taargeett folded before Flop (didn't bet)
Seat 3: simonrainbow (button) folded before Flop (didn't bet)
Seat 4: GuidoG8 (small blind) showed [4d Td] and lost with two pair, Tens and Fours
Seat 5: leodani2 (big blind) showed [4h 5h] and won (3931) with a straight, Four to Eight
Seat 6: TRISTAN10011 showed [Jc Ah] and lost with high card Ace
Seat 7: Dr McGregor folded before Flop (didn't bet)
Seat 8: ANG€L CARLOS folded before Flop (didn't bet)
Seat 9: LZ1212 folded before Flop (didn't bet)



PokerStars Hand #201497596624: Tournament #2629783708, 8700+1300 Hold'em No Limit - Level VII (125/250) - 2019/06/17 22:36:12 ET
Table '2629783708 14' 9-max Seat #5 is the button
Seat 1: catas1234925 (4510 in chips) 
Seat 2: Taargeett (7616 in chips) 
Seat 3: simonrainbow (4475 in chips) 
Seat 4: mmaatthh (5345 in chips) 
Seat 5: leodani2 (7831 in chips) 
Seat 6: Harrison5259 (1500 in chips) out of hand (moved from another table into small blind)
Seat 7: Dr McGregor (2070 in chips) 
Seat 8: ANG€L CARLOS (1500 in chips) 
Seat 9: LZ1212 (3490 in chips) 
Harrison5259 will be allowed to play after the button
catas1234925: posts the ante 25
Taargeett: posts the ante 25
simonrainbow: posts the ante 25
mmaatthh: posts the ante 25
leodani2: posts the ante 25
Dr McGregor: posts the ante 25
ANG€L CARLOS: posts the ante 25
LZ1212: posts the ante 25
Dr McGregor: posts small blind 125
ANG€L CARLOS: posts big blind 250
*** HOLE CARDS ***
Dealt to Taargeett [Js 7c]
LZ1212: folds 
catas1234925: folds 
Taargeett: folds 
simonrainbow: folds 
mmaatthh: calls 250
leodani2: calls 250
Dr McGregor: calls 125
ANG€L CARLOS: checks 
*** FLOP *** [8h 2c 3d]
Dr McGregor: checks 
ANG€L CARLOS: checks 
mmaatthh: bets 500
leodani2: calls 500
Dr McGregor: folds 
ANG€L CARLOS: folds 
*** TURN *** [8h 2c 3d] [6h]
mmaatthh: bets 1000
leodani2: folds 
Uncalled bet (1000) returned to mmaatthh
mmaatthh collected 2200 from pot
mmaatthh: doesn't show hand 
*** SUMMARY ***
Total pot 2200 | Rake 0 
Board [8h 2c 3d 6h]
Seat 1: catas1234925 folded before Flop (didn't bet)
Seat 2: Taargeett folded before Flop (didn't bet)
Seat 3: simonrainbow folded before Flop (didn't bet)
Seat 4: mmaatthh collected (2200)
Seat 5: leodani2 (button) folded on the Turn
Seat 7: Dr McGregor (small blind) folded on the Flop
Seat 8: ANG€L CARLOS (big blind) folded on the Flop
Seat 9: LZ1212 folded before Flop (didn't bet)



PokerStars Hand #201497612646: Tournament #2629783708, 8700+1300 Hold'em No Limit - Level VII (125/250) - 2019/06/17 22:37:21 ET
Table '2629783708 14' 9-max Seat #7 is the button
Seat 1: catas1234925 (4485 in chips) 
Seat 2: Taargeett (7591 in chips) 
Seat 3: simonrainbow (4450 in chips) 
Seat 4: mmaatthh (6770 in chips) 
Seat 5: leodani2 (7056 in chips) 
Seat 6: Harrison5259 (1500 in chips) 
Seat 7: Dr McGregor (1795 in chips) 
Seat 8: ANG€L CARLOS (1225 in chips) 
Seat 9: LZ1212 (3465 in chips) 
catas1234925: posts the ante 25
Taargeett: posts the ante 25
simonrainbow: posts the ante 25
mmaatthh: posts the ante 25
leodani2: posts the ante 25
Harrison5259: posts the ante 25
Dr McGregor: posts the ante 25
ANG€L CARLOS: posts the ante 25
LZ1212: posts the ante 25
ANG€L CARLOS: posts small blind 125
LZ1212: posts big blind 250
*** HOLE CARDS ***
Dealt to Taargeett [5d Jd]
catas1234925 is disconnected 
catas1234925 is connected 
catas1234925: calls 250
Taargeett: folds 
simonrainbow: folds 
mmaatthh: raises 750 to 1000
leodani2: calls 1000
Harrison5259: folds 
Dr McGregor: folds 
ANG€L CARLOS: raises 200 to 1200 and is all-in
LZ1212 has timed out
LZ1212: folds 
catas1234925: calls 950
mmaatthh: calls 200
leodani2: calls 200
*** FLOP *** [3c 6h 9h]
catas1234925: checks 
mmaatthh: bets 1750
leodani2: folds 
catas1234925: folds 
Uncalled bet (1750) returned to mmaatthh
*** TURN *** [3c 6h 9h] [2d]
*** RIVER *** [3c 6h 9h 2d] [9d]
*** SHOW DOWN ***
ANG€L CARLOS: shows [Ah Kc] (a pair of Nines)
mmaatthh: shows [Qs Qc] (two pair, Queens and Nines)
mmaatthh collected 5275 from pot
ANG€L CARLOS finished the tournament in 198th place
*** SUMMARY ***
Total pot 5275 | Rake 0 
Board [3c 6h 9h 2d 9d]
Seat 1: catas1234925 folded on the Flop
Seat 2: Taargeett folded before Flop (didn't bet)
Seat 3: simonrainbow folded before Flop (didn't bet)
Seat 4: mmaatthh showed [Qs Qc] and won (5275) with two pair, Queens and Nines
Seat 5: leodani2 folded on the Flop
Seat 6: Harrison5259 folded before Flop (didn't bet)
Seat 7: Dr McGregor (button) folded before Flop (didn't bet)
Seat 8: ANG€L CARLOS (small blind) showed [Ah Kc] and lost with a pair of Nines
Seat 9: LZ1212 (big blind) folded before Flop



PokerStars Hand #201497635388: Tournament #2629783708, 8700+1300 Hold'em No Limit - Level VII (125/250) - 2019/06/17 22:38:59 ET
Table '2629783708 14' 9-max Seat #9 is the button
Seat 1: catas1234925 (3260 in chips) 
Seat 2: Taargeett (7566 in chips) 
Seat 3: simonrainbow (4425 in chips) 
Seat 4: mmaatthh (10820 in chips) 
Seat 5: leodani2 (5831 in chips) 
Seat 6: Harrison5259 (1475 in chips) 
Seat 7: Dr McGregor (1770 in chips) 
Seat 9: LZ1212 (3190 in chips) is sitting out
catas1234925: posts the ante 25
Taargeett: posts the ante 25
simonrainbow: posts the ante 25
mmaatthh: posts the ante 25
leodani2: posts the ante 25
Harrison5259: posts the ante 25
Dr McGregor: posts the ante 25
LZ1212: posts the ante 25
catas1234925: posts small blind 125
Taargeett: posts big blind 250
*** HOLE CARDS ***
Dealt to Taargeett [Ah Qs]
simonrainbow: folds 
mmaatthh: folds 
leodani2: calls 250
Harrison5259: folds 
Dr McGregor: folds 
LZ1212: folds 
catas1234925: calls 125
Taargeett: raises 500 to 750
leodani2: calls 500
catas1234925: calls 500
*** FLOP *** [2s 9h 2d]
catas1234925: checks 
Taargeett: bets 2450
leodani2: folds 
catas1234925: folds 
Uncalled bet (2450) returned to Taargeett
Taargeett collected 2450 from pot
Taargeett: doesn't show hand 
*** SUMMARY ***
Total pot 2450 | Rake 0 
Board [2s 9h 2d]
Seat 1: catas1234925 (small blind) folded on the Flop
Seat 2: Taargeett (big blind) collected (2450)
Seat 3: simonrainbow folded before Flop (didn't bet)
Seat 4: mmaatthh folded before Flop (didn't bet)
Seat 5: leodani2 folded on the Flop
Seat 6: Harrison5259 folded before Flop (didn't bet)
Seat 7: Dr McGregor folded before Flop (didn't bet)
Seat 9: LZ1212 (button) folded before Flop (didn't bet)



PokerStars Hand #201497643132: Tournament #2629783708, 8700+1300 Hold'em No Limit - Level VII (125/250) - 2019/06/17 22:39:33 ET
Table '2629783708 14' 9-max Seat #1 is the button
Seat 1: catas1234925 (2485 in chips) 
Seat 2: Taargeett (9241 in chips) 
Seat 3: simonrainbow (4400 in chips) 
Seat 4: mmaatthh (10795 in chips) 
Seat 5: leodani2 (5056 in chips) 
Seat 6: Harrison5259 (1450 in chips) 
Seat 7: Dr McGregor (1745 in chips) 
Seat 9: LZ1212 (3165 in chips) is sitting out
catas1234925: posts the ante 25
Taargeett: posts the ante 25
simonrainbow: posts the ante 25
mmaatthh: posts the ante 25
leodani2: posts the ante 25
Harrison5259: posts the ante 25
Dr McGregor: posts the ante 25
LZ1212: posts the ante 25
Taargeett: posts small blind 125
simonrainbow: posts big blind 250
*** HOLE CARDS ***
Dealt to Taargeett [9s 2c]
mmaatthh: folds 
leodani2: folds 
Harrison5259: folds 
Dr McGregor: calls 250
LZ1212: folds 
catas1234925: folds 
Taargeett: folds 
simonrainbow: checks 
*** FLOP *** [Qh Kc 5c]
simonrainbow: bets 550
Dr McGregor: calls 550
*** TURN *** [Qh Kc 5c] [5h]
simonrainbow: bets 1283
Dr McGregor: calls 920 and is all-in
Uncalled bet (363) returned to simonrainbow
*** RIVER *** [Qh Kc 5c 5h] [4h]
*** SHOW DOWN ***
simonrainbow: shows [8h Qd] (two pair, Queens and Fives)
Dr McGregor: shows [Ac 5s] (three of a kind, Fives)
Dr McGregor collected 3765 from pot
*** SUMMARY ***
Total pot 3765 | Rake 0 
Board [Qh Kc 5c 5h 4h]
Seat 1: catas1234925 (button) folded before Flop (didn't bet)
Seat 2: Taargeett (small blind) folded before Flop
Seat 3: simonrainbow (big blind) showed [8h Qd] and lost with two pair, Queens and Fives
Seat 4: mmaatthh folded before Flop (didn't bet)
Seat 5: leodani2 folded before Flop (didn't bet)
Seat 6: Harrison5259 folded before Flop (didn't bet)
Seat 7: Dr McGregor showed [Ac 5s] and won (3765) with three of a kind, Fives
Seat 9: LZ1212 folded before Flop (didn't bet)



PokerStars Hand #201497653226: Tournament #2629783708, 8700+1300 Hold'em No Limit - Level VIII (150/300) - 2019/06/17 22:40:17 ET
Table '2629783708 14' 9-max Seat #2 is the button
Seat 1: catas1234925 (2460 in chips) 
Seat 2: Taargeett (9091 in chips) 
Seat 3: simonrainbow (2655 in chips) 
Seat 4: mmaatthh (10770 in chips) 
Seat 5: leodani2 (5031 in chips) 
Seat 6: Harrison5259 (1425 in chips) 
Seat 7: Dr McGregor (3765 in chips) 
Seat 8: Ruslan55region (707 in chips) 
Seat 9: LZ1212 (3140 in chips) is sitting out
catas1234925: posts the ante 25
Taargeett: posts the ante 25
simonrainbow: posts the ante 25
mmaatthh: posts the ante 25
leodani2: posts the ante 25
Harrison5259: posts the ante 25
Dr McGregor: posts the ante 25
Ruslan55region: posts the ante 25
LZ1212: posts the ante 25
simonrainbow: posts small blind 150
mmaatthh: posts big blind 300
*** HOLE CARDS ***
Dealt to Taargeett [4c 9c]
leodani2: folds 
Harrison5259: folds 
Dr McGregor: folds 
Ruslan55region: folds 
LZ1212: folds 
catas1234925: raises 300 to 600
Taargeett: folds 
simonrainbow: folds 
mmaatthh: folds 
Uncalled bet (300) returned to catas1234925
catas1234925 collected 975 from pot
catas1234925: doesn't show hand 
*** SUMMARY ***
Total pot 975 | Rake 0 
Seat 1: catas1234925 collected (975)
Seat 2: Taargeett (button) folded before Flop (didn't bet)
Seat 3: simonrainbow (small blind) folded before Flop
Seat 4: mmaatthh (big blind) folded before Flop
Seat 5: leodani2 folded before Flop (didn't bet)
Seat 6: Harrison5259 folded before Flop (didn't bet)
Seat 7: Dr McGregor folded before Flop (didn't bet)
Seat 8: Ruslan55region folded before Flop (didn't bet)
Seat 9: LZ1212 folded before Flop (didn't bet)



PokerStars Hand #201497662225: Tournament #2629783708, 8700+1300 Hold'em No Limit - Level VIII (150/300) - 2019/06/17 22:40:56 ET
Table '2629783708 14' 9-max Seat #3 is the button
Seat 1: catas1234925 (3110 in chips) 
Seat 2: Taargeett (9066 in chips) 
Seat 3: simonrainbow (2480 in chips) 
Seat 4: mmaatthh (10445 in chips) 
Seat 5: leodani2 (5006 in chips) 
Seat 6: Harrison5259 (1400 in chips) 
Seat 7: Dr McGregor (3740 in chips) 
Seat 8: Ruslan55region (682 in chips) 
Seat 9: LZ1212 (3115 in chips) is sitting out
catas1234925: posts the ante 25
Taargeett: posts the ante 25
simonrainbow: posts the ante 25
mmaatthh: posts the ante 25
leodani2: posts the ante 25
Harrison5259: posts the ante 25
Dr McGregor: posts the ante 25
Ruslan55region: posts the ante 25
LZ1212: posts the ante 25
mmaatthh: posts small blind 150
leodani2: posts big blind 300
*** HOLE CARDS ***
Dealt to Taargeett [Qd 6d]
Harrison5259: folds 
Dr McGregor: calls 300
Ruslan55region: folds 
LZ1212: folds 
catas1234925: raises 300 to 600
Taargeett: folds 
simonrainbow: calls 600
mmaatthh: folds 
leodani2: calls 300
Dr McGregor: calls 300
*** FLOP *** [8h 7s 9h]
leodani2: checks 
Dr McGregor: checks 
catas1234925: bets 300
simonrainbow: raises 1555 to 1855 and is all-in
leodani2: calls 1855
Dr McGregor: calls 1855
catas1234925: calls 1555
*** TURN *** [8h 7s 9h] [7h]
leodani2: checks 
Dr McGregor: checks 
catas1234925: checks 
*** RIVER *** [8h 7s 9h 7h] [4d]
leodani2: checks 
Dr McGregor: checks 
catas1234925: checks 
*** SHOW DOWN ***
leodani2: shows [6h 3s] (a pair of Sevens)
Dr McGregor: shows [Kd Td] (a pair of Sevens - King kicker)
catas1234925: shows [Jh Ac] (a pair of Sevens - Ace kicker)
simonrainbow: shows [8d 7d] (a full house, Sevens full of Eights)
simonrainbow collected 10195 from pot
*** SUMMARY ***
Total pot 10195 | Rake 0 
Board [8h 7s 9h 7h 4d]
Seat 1: catas1234925 showed [Jh Ac] and lost with a pair of Sevens
Seat 2: Taargeett folded before Flop (didn't bet)
Seat 3: simonrainbow (button) showed [8d 7d] and won (10195) with a full house, Sevens full of Eights
Seat 4: mmaatthh (small blind) folded before Flop
Seat 5: leodani2 (big blind) showed [6h 3s] and lost with a pair of Sevens
Seat 6: Harrison5259 folded before Flop (didn't bet)
Seat 7: Dr McGregor showed [Kd Td] and lost with a pair of Sevens
Seat 8: Ruslan55region folded before Flop (didn't bet)
Seat 9: LZ1212 folded before Flop (didn't bet)



PokerStars Hand #201497680975: Tournament #2629783708, 8700+1300 Hold'em No Limit - Level VIII (150/300) - 2019/06/17 22:42:04 ET
Table '2629783708 14' 9-max Seat #4 is the button
Seat 1: catas1234925 (630 in chips) 
Seat 2: Taargeett (9041 in chips) 
Seat 3: simonrainbow (10195 in chips) 
Seat 4: mmaatthh (10270 in chips) 
Seat 5: leodani2 (2526 in chips) 
Seat 6: Harrison5259 (1375 in chips) 
Seat 7: Dr McGregor (1260 in chips) 
Seat 8: Ruslan55region (657 in chips) 
Seat 9: LZ1212 (3090 in chips) 
catas1234925: posts the ante 25
Taargeett: posts the ante 25
simonrainbow: posts the ante 25
mmaatthh: posts the ante 25
leodani2: posts the ante 25
Harrison5259: posts the ante 25
Dr McGregor: posts the ante 25
Ruslan55region: posts the ante 25
LZ1212: posts the ante 25
leodani2: posts small blind 150
Harrison5259: posts big blind 300
*** HOLE CARDS ***
Dealt to Taargeett [3c 6d]
Dr McGregor: folds 
Ruslan55region: folds 
LZ1212: folds 
catas1234925: raises 305 to 605 and is all-in
Taargeett: folds 
simonrainbow: folds 
mmaatthh: folds 
leodani2: calls 455
Harrison5259: folds 
*** FLOP *** [Tc 3s 5s]
*** TURN *** [Tc 3s 5s] [3h]
*** RIVER *** [Tc 3s 5s 3h] [Js]
*** SHOW DOWN ***
leodani2: shows [As Jh] (two pair, Jacks and Threes)
catas1234925: shows [Ac 3d] (three of a kind, Threes)
catas1234925 collected 1735 from pot
*** SUMMARY ***
Total pot 1735 | Rake 0 
Board [Tc 3s 5s 3h Js]
Seat 1: catas1234925 showed [Ac 3d] and won (1735) with three of a kind, Threes
Seat 2: Taargeett folded before Flop (didn't bet)
Seat 3: simonrainbow folded before Flop (didn't bet)
Seat 4: mmaatthh (button) folded before Flop (didn't bet)
Seat 5: leodani2 (small blind) showed [As Jh] and lost with two pair, Jacks and Threes
Seat 6: Harrison5259 (big blind) folded before Flop
Seat 7: Dr McGregor folded before Flop (didn't bet)
Seat 8: Ruslan55region folded before Flop (didn't bet)
Seat 9: LZ1212 folded before Flop (didn't bet)



PokerStars Hand #201497689912: Tournament #2629783708, 8700+1300 Hold'em No Limit - Level VIII (150/300) - 2019/06/17 22:42:43 ET
Table '2629783708 14' 9-max Seat #5 is the button
Seat 1: catas1234925 (1735 in chips) 
Seat 2: Taargeett (9016 in chips) 
Seat 3: simonrainbow (10170 in chips) 
Seat 4: mmaatthh (10245 in chips) 
Seat 5: leodani2 (1896 in chips) 
Seat 6: Harrison5259 (1050 in chips) 
Seat 7: Dr McGregor (1235 in chips) 
Seat 8: Ruslan55region (632 in chips) 
Seat 9: LZ1212 (3065 in chips) 
catas1234925: posts the ante 25
Taargeett: posts the ante 25
simonrainbow: posts the ante 25
mmaatthh: posts the ante 25
leodani2: posts the ante 25
Harrison5259: posts the ante 25
Dr McGregor: posts the ante 25
Ruslan55region: posts the ante 25
LZ1212: posts the ante 25
Harrison5259: posts small blind 150
Dr McGregor: posts big blind 300
*** HOLE CARDS ***
Dealt to Taargeett [Ah 5c]
Ruslan55region: folds 
LZ1212: folds 
catas1234925: folds 
Taargeett: folds 
simonrainbow: folds 
mmaatthh: folds 
leodani2: folds 
Harrison5259: calls 150
Dr McGregor: checks 
*** FLOP *** [4h 5h 7h]
Harrison5259: checks 
Dr McGregor: bets 300
Harrison5259: folds 
Uncalled bet (300) returned to Dr McGregor
Dr McGregor collected 825 from pot
Dr McGregor: doesn't show hand 
*** SUMMARY ***
Total pot 825 | Rake 0 
Board [4h 5h 7h]
Seat 1: catas1234925 folded before Flop (didn't bet)
Seat 2: Taargeett folded before Flop (didn't bet)
Seat 3: simonrainbow folded before Flop (didn't bet)
Seat 4: mmaatthh folded before Flop (didn't bet)
Seat 5: leodani2 (button) folded before Flop (didn't bet)
Seat 6: Harrison5259 (small blind) folded on the Flop
Seat 7: Dr McGregor (big blind) collected (825)
Seat 8: Ruslan55region folded before Flop (didn't bet)
Seat 9: LZ1212 folded before Flop (didn't bet)



PokerStars Hand #201497698371: Tournament #2629783708, 8700+1300 Hold'em No Limit - Level VIII (150/300) - 2019/06/17 22:43:20 ET
Table '2629783708 14' 9-max Seat #6 is the button
Seat 1: catas1234925 (1710 in chips) 
Seat 2: Taargeett (8991 in chips) 
Seat 3: simonrainbow (10145 in chips) 
Seat 4: mmaatthh (10220 in chips) 
Seat 5: leodani2 (1871 in chips) 
Seat 6: Harrison5259 (725 in chips) 
Seat 7: Dr McGregor (1735 in chips) 
Seat 8: Ruslan55region (607 in chips) 
Seat 9: LZ1212 (3040 in chips) 
catas1234925: posts the ante 25
Taargeett: posts the ante 25
simonrainbow: posts the ante 25
mmaatthh: posts the ante 25
leodani2: posts the ante 25
Harrison5259: posts the ante 25
Dr McGregor: posts the ante 25
Ruslan55region: posts the ante 25
LZ1212: posts the ante 25
Dr McGregor: posts small blind 150
Ruslan55region: posts big blind 300
*** HOLE CARDS ***
Dealt to Taargeett [Js 4d]
LZ1212: folds 
catas1234925: raises 300 to 600
Taargeett: folds 
simonrainbow: folds 
mmaatthh: folds 
leodani2: calls 600
Harrison5259: raises 100 to 700 and is all-in
Dr McGregor: folds 
Ruslan55region: calls 282 and is all-in
catas1234925: calls 100
leodani2: calls 100
*** FLOP *** [Ts Tc 6d]
catas1234925: bets 300
leodani2: calls 300
*** TURN *** [Ts Tc 6d] [7d]
catas1234925: checks 
leodani2: bets 846 and is all-in
catas1234925: calls 685 and is all-in
Uncalled bet (161) returned to leodani2
*** RIVER *** [Ts Tc 6d 7d] [5c]
*** SHOW DOWN ***
catas1234925: shows [2c Ah] (a pair of Tens)
leodani2: shows [7s Kc] (two pair, Tens and Sevens)
leodani2 collected 1970 from side pot-2 
Harrison5259: shows [Jh Kh] (a pair of Tens)
leodani2 collected 354 from side pot-1 
Ruslan55region: shows [5h 3d] (two pair, Tens and Fives)
leodani2 collected 2703 from main pot
catas1234925 finished the tournament in 144th place
Harrison5259 finished the tournament in 145th place
Ruslan55region finished the tournament in 146th place
*** SUMMARY ***
Total pot 5027 Main pot 2703. Side pot-1 354. Side pot-2 1970. | Rake 0 
Board [Ts Tc 6d 7d 5c]
Seat 1: catas1234925 showed [2c Ah] and lost with a pair of Tens
Seat 2: Taargeett folded before Flop (didn't bet)
Seat 3: simonrainbow folded before Flop (didn't bet)
Seat 4: mmaatthh folded before Flop (didn't bet)
Seat 5: leodani2 showed [7s Kc] and won (5027) with two pair, Tens and Sevens
Seat 6: Harrison5259 (button) showed [Jh Kh] and lost with a pair of Tens
Seat 7: Dr McGregor (small blind) folded before Flop
Seat 8: Ruslan55region (big blind) showed [5h 3d] and lost with two pair, Tens and Fives
Seat 9: LZ1212 folded before Flop (didn't bet)



PokerStars Hand #201497712215: Tournament #2629783708, 8700+1300 Hold'em No Limit - Level VIII (150/300) - 2019/06/17 22:44:22 ET
Table '2629783708 4' 9-max Seat #3 is the button
Seat 1: McHagrid (850 in chips) 
Seat 2: ArcticOrange (4876 in chips) is sitting out
Seat 3: JEC rules (13540 in chips) 
Seat 4: Aune10 (1695 in chips) 
Seat 5: Taargeett (8966 in chips) 
Seat 6: juniorDS_420 (5175 in chips) 
Seat 7: Bigfoot05 (2595 in chips) 
Seat 8: gizmostar (2375 in chips) 
Seat 9: toto87967 (14985 in chips) 
McHagrid: posts the ante 25
ArcticOrange: posts the ante 25
JEC rules: posts the ante 25
Aune10: posts the ante 25
Taargeett: posts the ante 25
juniorDS_420: posts the ante 25
Bigfoot05: posts the ante 25
gizmostar: posts the ante 25
toto87967: posts the ante 25
Aune10: posts small blind 150
Taargeett: posts big blind 300
*** HOLE CARDS ***
Dealt to Taargeett [6s Ts]
juniorDS_420: folds 
Bigfoot05: folds 
gizmostar: calls 300
toto87967: calls 300
McHagrid: folds 
ArcticOrange: folds 
JEC rules: calls 300
Aune10: folds 
Taargeett: checks 
*** FLOP *** [6d Qh 4d]
Taargeett: checks 
gizmostar: checks 
toto87967: checks 
JEC rules: checks 
*** TURN *** [6d Qh 4d] [2h]
Taargeett: bets 1575
gizmostar: folds 
toto87967: folds 
JEC rules: folds 
Uncalled bet (1575) returned to Taargeett
Taargeett collected 1575 from pot
Taargeett: doesn't show hand 
*** SUMMARY ***
Total pot 1575 | Rake 0 
Board [6d Qh 4d 2h]
Seat 1: McHagrid folded before Flop (didn't bet)
Seat 2: ArcticOrange folded before Flop (didn't bet)
Seat 3: JEC rules (button) folded on the Turn
Seat 4: Aune10 (small blind) folded before Flop
Seat 5: Taargeett (big blind) collected (1575)
Seat 6: juniorDS_420 folded before Flop (didn't bet)
Seat 7: Bigfoot05 folded before Flop (didn't bet)
Seat 8: gizmostar folded on the Turn
Seat 9: toto87967 folded on the Turn



PokerStars Hand #201497722463: Tournament #2629783708, 8700+1300 Hold'em No Limit - Level IX (200/400) - 2019/06/17 22:45:08 ET
Table '2629783708 4' 9-max Seat #4 is the button
Seat 1: McHagrid (825 in chips) 
Seat 2: ArcticOrange (4851 in chips) is sitting out
Seat 3: JEC rules (13215 in chips) 
Seat 4: Aune10 (1520 in chips) 
Seat 5: Taargeett (10216 in chips) 
Seat 6: juniorDS_420 (5150 in chips) 
Seat 7: Bigfoot05 (2570 in chips) 
Seat 8: gizmostar (2050 in chips) 
Seat 9: toto87967 (14660 in chips) 
McHagrid: posts the ante 50
ArcticOrange: posts the ante 50
JEC rules: posts the ante 50
Aune10: posts the ante 50
Taargeett: posts the ante 50
juniorDS_420: posts the ante 50
Bigfoot05: posts the ante 50
gizmostar: posts the ante 50
toto87967: posts the ante 50
Taargeett: posts small blind 200
juniorDS_420: posts big blind 400
*** HOLE CARDS ***
Dealt to Taargeett [Ks 2s]
Bigfoot05: folds 
gizmostar: folds 
toto87967: calls 400
McHagrid: folds 
ArcticOrange: folds 
JEC rules: folds 
Aune10: calls 400
Taargeett: folds 
juniorDS_420: checks 
*** FLOP *** [6d 8c As]
juniorDS_420: checks 
toto87967: bets 400
Aune10: calls 400
juniorDS_420: folds 
*** TURN *** [6d 8c As] [9c]
toto87967: bets 400
Aune10: raises 270 to 670 and is all-in
toto87967: calls 270
*** RIVER *** [6d 8c As 9c] [2h]
*** SHOW DOWN ***
toto87967: shows [Ah 3s] (a pair of Aces)
Aune10: shows [3h 3c] (a pair of Threes)
toto87967 collected 3990 from pot
Aune10 finished the tournament in 140th place
*** SUMMARY ***
Total pot 3990 | Rake 0 
Board [6d 8c As 9c 2h]
Seat 1: McHagrid folded before Flop (didn't bet)
Seat 2: ArcticOrange folded before Flop (didn't bet)
Seat 3: JEC rules folded before Flop (didn't bet)
Seat 4: Aune10 (button) showed [3h 3c] and lost with a pair of Threes
Seat 5: Taargeett (small blind) folded before Flop
Seat 6: juniorDS_420 (big blind) folded on the Flop
Seat 7: Bigfoot05 folded before Flop (didn't bet)
Seat 8: gizmostar folded before Flop (didn't bet)
Seat 9: toto87967 showed [Ah 3s] and won (3990) with a pair of Aces



PokerStars Hand #201497729420: Tournament #2629783708, 8700+1300 Hold'em No Limit - Level IX (200/400) - 2019/06/17 22:45:39 ET
Table '2629783708 4' 9-max Seat #5 is the button
Seat 1: McHagrid (775 in chips) 
Seat 2: ArcticOrange (4801 in chips) is sitting out
Seat 3: JEC rules (13165 in chips) 
Seat 5: Taargeett (9966 in chips) 
Seat 6: juniorDS_420 (4700 in chips) 
Seat 7: Bigfoot05 (2520 in chips) 
Seat 8: gizmostar (2000 in chips) 
Seat 9: toto87967 (17130 in chips) 
McHagrid: posts the ante 50
ArcticOrange: posts the ante 50
JEC rules: posts the ante 50
Taargeett: posts the ante 50
juniorDS_420: posts the ante 50
Bigfoot05: posts the ante 50
gizmostar: posts the ante 50
toto87967: posts the ante 50
juniorDS_420: posts small blind 200
Bigfoot05: posts big blind 400
*** HOLE CARDS ***
Dealt to Taargeett [9c 3s]
gizmostar: folds 
toto87967: calls 400
McHagrid: folds 
ArcticOrange: folds 
JEC rules: folds 
Taargeett: folds 
juniorDS_420: calls 200
Bigfoot05: raises 400 to 800
toto87967: calls 400
juniorDS_420: calls 400
*** FLOP *** [8d Qh 6h]
juniorDS_420: checks 
Bigfoot05: bets 1200
toto87967: folds 
juniorDS_420: folds 
Uncalled bet (1200) returned to Bigfoot05
Bigfoot05 collected 2800 from pot
*** SUMMARY ***
Total pot 2800 | Rake 0 
Board [8d Qh 6h]
Seat 1: McHagrid folded before Flop (didn't bet)
Seat 2: ArcticOrange folded before Flop (didn't bet)
Seat 3: JEC rules folded before Flop (didn't bet)
Seat 5: Taargeett (button) folded before Flop (didn't bet)
Seat 6: juniorDS_420 (small blind) folded on the Flop
Seat 7: Bigfoot05 (big blind) collected (2800)
Seat 8: gizmostar folded before Flop (didn't bet)
Seat 9: toto87967 folded on the Flop



PokerStars Hand #201497738068: Tournament #2629783708, 8700+1300 Hold'em No Limit - Level IX (200/400) - 2019/06/17 22:46:18 ET
Table '2629783708 4' 9-max Seat #6 is the button
Seat 1: McHagrid (725 in chips) 
Seat 2: ArcticOrange (4751 in chips) is sitting out
Seat 3: JEC rules (13115 in chips) 
Seat 5: Taargeett (9916 in chips) 
Seat 6: juniorDS_420 (3850 in chips) 
Seat 7: Bigfoot05 (4470 in chips) 
Seat 8: gizmostar (1950 in chips) 
Seat 9: toto87967 (16280 in chips) 
McHagrid: posts the ante 50
ArcticOrange: posts the ante 50
JEC rules: posts the ante 50
Taargeett: posts the ante 50
juniorDS_420: posts the ante 50
Bigfoot05: posts the ante 50
gizmostar: posts the ante 50
toto87967: posts the ante 50
Bigfoot05: posts small blind 200
gizmostar: posts big blind 400
*** HOLE CARDS ***
Dealt to Taargeett [3h Ks]
toto87967: folds 
McHagrid: folds 
ArcticOrange: folds 
JEC rules: folds 
Taargeett: folds 
juniorDS_420: folds 
Bigfoot05: calls 200
gizmostar: checks 
*** FLOP *** [7h 3d 2h]
Bigfoot05: checks 
gizmostar: checks 
*** TURN *** [7h 3d 2h] [Ah]
Bigfoot05: checks 
gizmostar: bets 400
Bigfoot05: calls 400
*** RIVER *** [7h 3d 2h Ah] [Td]
Bigfoot05: checks 
gizmostar: bets 400
Bigfoot05: folds 
Uncalled bet (400) returned to gizmostar
gizmostar collected 2000 from pot
*** SUMMARY ***
Total pot 2000 | Rake 0 
Board [7h 3d 2h Ah Td]
Seat 1: McHagrid folded before Flop (didn't bet)
Seat 2: ArcticOrange folded before Flop (didn't bet)
Seat 3: JEC rules folded before Flop (didn't bet)
Seat 5: Taargeett folded before Flop (didn't bet)
Seat 6: juniorDS_420 (button) folded before Flop (didn't bet)
Seat 7: Bigfoot05 (small blind) folded on the River
Seat 8: gizmostar (big blind) collected (2000)
Seat 9: toto87967 folded before Flop (didn't bet)



PokerStars Hand #201497748702: Tournament #2629783708, 8700+1300 Hold'em No Limit - Level IX (200/400) - 2019/06/17 22:47:06 ET
Table '2629783708 4' 9-max Seat #7 is the button
Seat 1: McHagrid (675 in chips) 
Seat 2: ArcticOrange (4701 in chips) is sitting out
Seat 3: JEC rules (13065 in chips) 
Seat 4: Regalin (350 in chips) is sitting out
Seat 5: Taargeett (9866 in chips) 
Seat 6: juniorDS_420 (3800 in chips) 
Seat 7: Bigfoot05 (3620 in chips) 
Seat 8: gizmostar (3100 in chips) 
Seat 9: toto87967 (16230 in chips) 
McHagrid: posts the ante 50
ArcticOrange: posts the ante 50
JEC rules: posts the ante 50
Regalin: posts the ante 50
Taargeett: posts the ante 50
juniorDS_420: posts the ante 50
Bigfoot05: posts the ante 50
gizmostar: posts the ante 50
toto87967: posts the ante 50
gizmostar: posts small blind 200
toto87967: posts big blind 400
*** HOLE CARDS ***
Dealt to Taargeett [4s 7d]
McHagrid: folds 
ArcticOrange: folds 
JEC rules: folds 
Regalin: folds 
Taargeett: folds 
juniorDS_420: folds 
Bigfoot05: folds 
gizmostar: calls 200
toto87967: checks 
*** FLOP *** [4c Jc 5h]
gizmostar: checks 
toto87967: checks 
*** TURN *** [4c Jc 5h] [Jh]
gizmostar: checks 
toto87967: checks 
*** RIVER *** [4c Jc 5h Jh] [8d]
gizmostar: checks 
toto87967: checks 
*** SHOW DOWN ***
gizmostar: shows [Ad Th] (a pair of Jacks)
toto87967: shows [7s 4d] (two pair, Jacks and Fours)
toto87967 collected 1250 from pot
*** SUMMARY ***
Total pot 1250 | Rake 0 
Board [4c Jc 5h Jh 8d]
Seat 1: McHagrid folded before Flop (didn't bet)
Seat 2: ArcticOrange folded before Flop (didn't bet)
Seat 3: JEC rules folded before Flop (didn't bet)
Seat 4: Regalin folded before Flop (didn't bet)
Seat 5: Taargeett folded before Flop (didn't bet)
Seat 6: juniorDS_420 folded before Flop (didn't bet)
Seat 7: Bigfoot05 (button) folded before Flop (didn't bet)
Seat 8: gizmostar (small blind) showed [Ad Th] and lost with a pair of Jacks
Seat 9: toto87967 (big blind) showed [7s 4d] and won (1250) with two pair, Jacks and Fours



PokerStars Hand #201497756188: Tournament #2629783708, 8700+1300 Hold'em No Limit - Level IX (200/400) - 2019/06/17 22:47:40 ET
Table '2629783708 4' 9-max Seat #8 is the button
Seat 1: McHagrid (625 in chips) 
Seat 2: ArcticOrange (4651 in chips) is sitting out
Seat 3: JEC rules (13015 in chips) 
Seat 4: Regalin (300 in chips) is sitting out
Seat 5: Taargeett (9816 in chips) 
Seat 6: juniorDS_420 (3750 in chips) 
Seat 7: Bigfoot05 (3570 in chips) 
Seat 8: gizmostar (2650 in chips) 
Seat 9: toto87967 (17030 in chips) 
McHagrid: posts the ante 50
ArcticOrange: posts the ante 50
JEC rules: posts the ante 50
Regalin: posts the ante 50
Taargeett: posts the ante 50
juniorDS_420: posts the ante 50
Bigfoot05: posts the ante 50
gizmostar: posts the ante 50
toto87967: posts the ante 50
toto87967: posts small blind 200
McHagrid: posts big blind 400
*** HOLE CARDS ***
Dealt to Taargeett [Js 9h]
ArcticOrange: folds 
JEC rules: folds 
Regalin: folds 
Taargeett: folds 
juniorDS_420: calls 400
Bigfoot05: folds 
gizmostar: folds 
toto87967: calls 200
McHagrid: checks 
*** FLOP *** [Ts 2c 6s]
toto87967: bets 400
McHagrid: folds 
juniorDS_420: folds 
Uncalled bet (400) returned to toto87967
toto87967 collected 1650 from pot
toto87967: doesn't show hand 
*** SUMMARY ***
Total pot 1650 | Rake 0 
Board [Ts 2c 6s]
Seat 1: McHagrid (big blind) folded on the Flop
Seat 2: ArcticOrange folded before Flop (didn't bet)
Seat 3: JEC rules folded before Flop (didn't bet)
Seat 4: Regalin folded before Flop (didn't bet)
Seat 5: Taargeett folded before Flop (didn't bet)
Seat 6: juniorDS_420 folded on the Flop
Seat 7: Bigfoot05 folded before Flop (didn't bet)
Seat 8: gizmostar (button) folded before Flop (didn't bet)
Seat 9: toto87967 (small blind) collected (1650)



PokerStars Hand #201497761917: Tournament #2629783708, 8700+1300 Hold'em No Limit - Level IX (200/400) - 2019/06/17 22:48:06 ET
Table '2629783708 4' 9-max Seat #9 is the button
Seat 1: McHagrid (175 in chips) 
Seat 2: ArcticOrange (4601 in chips) is sitting out
Seat 3: JEC rules (12965 in chips) 
Seat 4: Regalin (250 in chips) is sitting out
Seat 5: Taargeett (9766 in chips) 
Seat 6: juniorDS_420 (3300 in chips) 
Seat 7: Bigfoot05 (3520 in chips) 
Seat 8: gizmostar (2600 in chips) 
Seat 9: toto87967 (18230 in chips) 
McHagrid: posts the ante 50
ArcticOrange: posts the ante 50
JEC rules: posts the ante 50
Regalin: posts the ante 50
Taargeett: posts the ante 50
juniorDS_420: posts the ante 50
Bigfoot05: posts the ante 50
gizmostar: posts the ante 50
toto87967: posts the ante 50
McHagrid: posts small blind 125 and is all-in
ArcticOrange: posts big blind 400
*** HOLE CARDS ***
Dealt to Taargeett [Js 7c]
JEC rules: calls 400
Regalin: folds 
Taargeett: folds 
juniorDS_420: folds 
Bigfoot05: folds 
gizmostar: folds 
toto87967: calls 400
ArcticOrange: folds 
*** FLOP *** [6c Ah 2c]
JEC rules: bets 800
toto87967: folds 
Uncalled bet (800) returned to JEC rules
*** TURN *** [6c Ah 2c] [9c]
*** RIVER *** [6c Ah 2c 9c] [3s]
*** SHOW DOWN ***
JEC rules: shows [9s As] (two pair, Aces and Nines)
JEC rules collected 825 from side pot
McHagrid: shows [Jc 9h] (a pair of Nines)
JEC rules collected 950 from main pot
McHagrid finished the tournament in 123rd place
*** SUMMARY ***
Total pot 1775 Main pot 950. Side pot 825. | Rake 0 
Board [6c Ah 2c 9c 3s]
Seat 1: McHagrid (small blind) showed [Jc 9h] and lost with a pair of Nines
Seat 2: ArcticOrange (big blind) folded before Flop
Seat 3: JEC rules showed [9s As] and won (1775) with two pair, Aces and Nines
Seat 4: Regalin folded before Flop (didn't bet)
Seat 5: Taargeett folded before Flop (didn't bet)
Seat 6: juniorDS_420 folded before Flop (didn't bet)
Seat 7: Bigfoot05 folded before Flop (didn't bet)
Seat 8: gizmostar folded before Flop (didn't bet)
Seat 9: toto87967 (button) folded on the Flop



PokerStars Hand #201497769195: Tournament #2629783708, 8700+1300 Hold'em No Limit - Level IX (200/400) - 2019/06/17 22:48:39 ET
Table '2629783708 4' 9-max Seat #2 is the button
Seat 2: ArcticOrange (4151 in chips) is sitting out
Seat 3: JEC rules (14290 in chips) 
Seat 4: Regalin (200 in chips) is sitting out
Seat 5: Taargeett (9716 in chips) 
Seat 6: juniorDS_420 (3250 in chips) 
Seat 7: Bigfoot05 (3470 in chips) 
Seat 8: gizmostar (2550 in chips) 
Seat 9: toto87967 (17780 in chips) 
ArcticOrange: posts the ante 50
JEC rules: posts the ante 50
Regalin: posts the ante 50
Taargeett: posts the ante 50
juniorDS_420: posts the ante 50
Bigfoot05: posts the ante 50
gizmostar: posts the ante 50
toto87967: posts the ante 50
JEC rules: posts small blind 200
Regalin: posts big blind 150 and is all-in
*** HOLE CARDS ***
Dealt to Taargeett [9h 8s]
Taargeett: folds 
juniorDS_420: raises 1000 to 1200
Bigfoot05: folds 
gizmostar: folds 
toto87967: folds 
ArcticOrange: folds 
JEC rules: folds 
Regalin: folds 
Uncalled bet (1000) returned to juniorDS_420
juniorDS_420 collected 950 from pot
Regalin finished the tournament in 121st place
juniorDS_420: doesn't show hand 
*** SUMMARY ***
Total pot 950 | Rake 0 
Seat 2: ArcticOrange (button) folded before Flop (didn't bet)
Seat 3: JEC rules (small blind) folded before Flop
Seat 4: Regalin (big blind) folded before Flop
Seat 5: Taargeett folded before Flop (didn't bet)
Seat 6: juniorDS_420 collected (950)
Seat 7: Bigfoot05 folded before Flop (didn't bet)
Seat 8: gizmostar folded before Flop (didn't bet)
Seat 9: toto87967 folded before Flop (didn't bet)



PokerStars Hand #201497773234: Tournament #2629783708, 8700+1300 Hold'em No Limit - Level IX (200/400) - 2019/06/17 22:48:58 ET
Table '2629783708 4' 9-max Seat #3 is the button
Seat 1: jimi_magic (2715 in chips) is sitting out
Seat 2: ArcticOrange (4101 in chips) is sitting out
Seat 3: JEC rules (14040 in chips) 
Seat 4: AUSSIE4POKER (8186 in chips) out of hand (moved from another table into small blind)
Seat 5: Taargeett (9666 in chips) 
Seat 6: juniorDS_420 (3950 in chips) 
Seat 7: Bigfoot05 (3420 in chips) 
Seat 8: gizmostar (2500 in chips) 
Seat 9: toto87967 (17730 in chips) 
AUSSIE4POKER will be allowed to play after the button
jimi_magic: posts the ante 50
ArcticOrange: posts the ante 50
JEC rules: posts the ante 50
Taargeett: posts the ante 50
juniorDS_420: posts the ante 50
Bigfoot05: posts the ante 50
gizmostar: posts the ante 50
toto87967: posts the ante 50
Taargeett: posts small blind 200
juniorDS_420: posts big blind 400
*** HOLE CARDS ***
Dealt to Taargeett [6d Ah]
Bigfoot05: folds 
gizmostar: folds 
toto87967: calls 400
jimi_magic: folds 
ArcticOrange: folds 
JEC rules: calls 400
Taargeett: folds 
juniorDS_420: checks 
*** FLOP *** [3s Kh 6s]
juniorDS_420: checks 
toto87967: bets 400
JEC rules: folds 
juniorDS_420: folds 
Uncalled bet (400) returned to toto87967
toto87967 collected 1800 from pot
toto87967: doesn't show hand 
*** SUMMARY ***
Total pot 1800 | Rake 0 
Board [3s Kh 6s]
Seat 1: jimi_magic folded before Flop (didn't bet)
Seat 2: ArcticOrange folded before Flop (didn't bet)
Seat 3: JEC rules (button) folded on the Flop
Seat 5: Taargeett (small blind) folded before Flop
Seat 6: juniorDS_420 (big blind) folded on the Flop
Seat 7: Bigfoot05 folded before Flop (didn't bet)
Seat 8: gizmostar folded before Flop (didn't bet)
Seat 9: toto87967 collected (1800)



PokerStars Hand #201497779862: Tournament #2629783708, 8700+1300 Hold'em No Limit - Level IX (200/400) - 2019/06/17 22:49:29 ET
Table '2629783708 4' 9-max Seat #5 is the button
Seat 1: jimi_magic (2665 in chips) is sitting out
Seat 2: ArcticOrange (4051 in chips) is sitting out
Seat 3: JEC rules (13590 in chips) 
Seat 4: AUSSIE4POKER (8186 in chips) 
Seat 5: Taargeett (9416 in chips) 
Seat 6: juniorDS_420 (3500 in chips) 
Seat 7: Bigfoot05 (3370 in chips) 
Seat 8: gizmostar (2450 in chips) 
Seat 9: toto87967 (19080 in chips) 
jimi_magic: posts the ante 50
ArcticOrange: posts the ante 50
JEC rules: posts the ante 50
AUSSIE4POKER: posts the ante 50
Taargeett: posts the ante 50
juniorDS_420: posts the ante 50
Bigfoot05: posts the ante 50
gizmostar: posts the ante 50
toto87967: posts the ante 50
juniorDS_420: posts small blind 200
Bigfoot05: posts big blind 400
*** HOLE CARDS ***
Dealt to Taargeett [6h 5c]
gizmostar: folds 
toto87967: calls 400
jimi_magic: folds 
ArcticOrange: folds 
JEC rules: folds 
AUSSIE4POKER: calls 400
Taargeett: folds 
juniorDS_420: calls 200
Bigfoot05: checks 
*** FLOP *** [3s 5h 7d]
juniorDS_420: checks 
Bigfoot05: checks 
toto87967: checks 
AUSSIE4POKER: checks 
*** TURN *** [3s 5h 7d] [Ac]
juniorDS_420: checks 
Bigfoot05: checks 
toto87967: checks 
AUSSIE4POKER: checks 
*** RIVER *** [3s 5h 7d Ac] [7h]
juniorDS_420: bets 1200
Bigfoot05: calls 1200
toto87967: folds 
AUSSIE4POKER: folds 
*** SHOW DOWN ***
juniorDS_420: shows [6c As] (two pair, Aces and Sevens)
Bigfoot05: mucks hand 
juniorDS_420 collected 4450 from pot
*** SUMMARY ***
Total pot 4450 | Rake 0 
Board [3s 5h 7d Ac 7h]
Seat 1: jimi_magic folded before Flop (didn't bet)
Seat 2: ArcticOrange folded before Flop (didn't bet)
Seat 3: JEC rules folded before Flop (didn't bet)
Seat 4: AUSSIE4POKER folded on the River
Seat 5: Taargeett (button) folded before Flop (didn't bet)
Seat 6: juniorDS_420 (small blind) showed [6c As] and won (4450) with two pair, Aces and Sevens
Seat 7: Bigfoot05 (big blind) mucked [Kh 4c]
Seat 8: gizmostar folded before Flop (didn't bet)
Seat 9: toto87967 folded on the River



PokerStars Hand #201497791624: Tournament #2629783708, 8700+1300 Hold'em No Limit - Level X (300/600) - 2019/06/17 22:50:23 ET
Table '2629783708 4' 9-max Seat #6 is the button
Seat 1: jimi_magic (2615 in chips) is sitting out
Seat 2: ArcticOrange (4001 in chips) is sitting out
Seat 3: JEC rules (13540 in chips) 
Seat 4: AUSSIE4POKER (7736 in chips) 
Seat 5: Taargeett (9366 in chips) 
Seat 6: juniorDS_420 (6300 in chips) 
Seat 7: Bigfoot05 (1720 in chips) 
Seat 8: gizmostar (2400 in chips) 
Seat 9: toto87967 (18630 in chips) 
jimi_magic: posts the ante 50
ArcticOrange: posts the ante 50
JEC rules: posts the ante 50
AUSSIE4POKER: posts the ante 50
Taargeett: posts the ante 50
juniorDS_420: posts the ante 50
Bigfoot05: posts the ante 50
gizmostar: posts the ante 50
toto87967: posts the ante 50
Bigfoot05: posts small blind 300
gizmostar: posts big blind 600
*** HOLE CARDS ***
Dealt to Taargeett [4d 8c]
toto87967: calls 600
jimi_magic: folds 
ArcticOrange: folds 
JEC rules: folds 
AUSSIE4POKER: folds 
Taargeett: folds 
juniorDS_420: folds 
Bigfoot05: calls 300
gizmostar: checks 
*** FLOP *** [8s 3h 3d]
Bigfoot05: checks 
gizmostar: checks 
toto87967: checks 
*** TURN *** [8s 3h 3d] [2s]
Bigfoot05: checks 
gizmostar: checks 
toto87967: checks 
*** RIVER *** [8s 3h 3d 2s] [Ac]
Bigfoot05: checks 
gizmostar: checks 
toto87967: checks 
*** SHOW DOWN ***
Bigfoot05: shows [Kh 7h] (a pair of Threes)
gizmostar: shows [2c Ks] (two pair, Threes and Deuces)
toto87967: mucks hand 
gizmostar collected 2250 from pot
*** SUMMARY ***
Total pot 2250 | Rake 0 
Board [8s 3h 3d 2s Ac]
Seat 1: jimi_magic folded before Flop (didn't bet)
Seat 2: ArcticOrange folded before Flop (didn't bet)
Seat 3: JEC rules folded before Flop (didn't bet)
Seat 4: AUSSIE4POKER folded before Flop (didn't bet)
Seat 5: Taargeett folded before Flop (didn't bet)
Seat 6: juniorDS_420 (button) folded before Flop (didn't bet)
Seat 7: Bigfoot05 (small blind) showed [Kh 7h] and lost with a pair of Threes
Seat 8: gizmostar (big blind) showed [2c Ks] and won (2250) with two pair, Threes and Deuces
Seat 9: toto87967 mucked [9d Qs]



PokerStars Hand #201497799225: Tournament #2629783708, 8700+1300 Hold'em No Limit - Level X (300/600) - 2019/06/17 22:50:59 ET
Table '2629783708 4' 9-max Seat #7 is the button
Seat 1: jimi_magic (2565 in chips) is sitting out
Seat 2: ArcticOrange (3951 in chips) is sitting out
Seat 3: JEC rules (13490 in chips) 
Seat 4: AUSSIE4POKER (7686 in chips) 
Seat 5: Taargeett (9316 in chips) 
Seat 6: juniorDS_420 (6250 in chips) 
Seat 7: Bigfoot05 (1070 in chips) 
Seat 8: gizmostar (4000 in chips) 
Seat 9: toto87967 (17980 in chips) 
jimi_magic: posts the ante 50
ArcticOrange: posts the ante 50
JEC rules: posts the ante 50
AUSSIE4POKER: posts the ante 50
Taargeett: posts the ante 50
juniorDS_420: posts the ante 50
Bigfoot05: posts the ante 50
gizmostar: posts the ante 50
toto87967: posts the ante 50
gizmostar: posts small blind 300
toto87967: posts big blind 600
*** HOLE CARDS ***
Dealt to Taargeett [4d 6h]
jimi_magic: folds 
ArcticOrange: folds 
JEC rules: calls 600
AUSSIE4POKER: calls 600
Taargeett: folds 
juniorDS_420: folds 
Bigfoot05: raises 420 to 1020 and is all-in
gizmostar: folds 
toto87967: calls 420
JEC rules: calls 420
AUSSIE4POKER: calls 420
*** FLOP *** [2s 9c Kd]
toto87967: checks 
JEC rules: checks 
AUSSIE4POKER: checks 
*** TURN *** [2s 9c Kd] [Td]
toto87967: checks 
JEC rules: bets 600
AUSSIE4POKER: folds 
toto87967: folds 
Uncalled bet (600) returned to JEC rules
*** RIVER *** [2s 9c Kd Td] [6d]
*** SHOW DOWN ***
JEC rules: shows [Ad 2d] (a flush, Ace high)
Bigfoot05: shows [Jd Ks] (a pair of Kings)
JEC rules collected 4830 from pot
*** SUMMARY ***
Total pot 4830 | Rake 0 
Board [2s 9c Kd Td 6d]
Seat 1: jimi_magic folded before Flop (didn't bet)
Seat 2: ArcticOrange folded before Flop (didn't bet)
Seat 3: JEC rules showed [Ad 2d] and won (4830) with a flush, Ace high
Seat 4: AUSSIE4POKER folded on the Turn
Seat 5: Taargeett folded before Flop (didn't bet)
Seat 6: juniorDS_420 folded before Flop (didn't bet)
Seat 7: Bigfoot05 (button) showed [Jd Ks] and lost with a pair of Kings
Seat 8: gizmostar (small blind) folded before Flop
Seat 9: toto87967 (big blind) folded on the Turn



PokerStars Hand #201497819249: Tournament #2629783708, 8700+1300 Hold'em No Limit - Level X (300/600) - 2019/06/17 22:52:32 ET
Table '2629783708 19' 9-max Seat #1 is the button
Seat 1: Rhea242 (10760 in chips) 
Seat 2: Little O56 (912 in chips) 
Seat 3: mariocai (8124 in chips) 
Seat 4: hernan646 (7887 in chips) 
Seat 5: dan399 (1862 in chips) 
Seat 6: KingTT1 (12377 in chips) 
Seat 7: Taargeett (9266 in chips) 
Seat 8: serrot27 (7716 in chips) 
Seat 9: cant_remembr (790 in chips) 
Rhea242: posts the ante 50
Little O56: posts the ante 50
mariocai: posts the ante 50
hernan646: posts the ante 50
dan399: posts the ante 50
KingTT1: posts the ante 50
Taargeett: posts the ante 50
serrot27: posts the ante 50
cant_remembr: posts the ante 50
Little O56: posts small blind 300
mariocai: posts big blind 600
*** HOLE CARDS ***
Dealt to Taargeett [Ts Tc]
hernan646: folds 
dan399: folds 
KingTT1: folds 
Taargeett: raises 1200 to 1800
serrot27: folds 
cant_remembr: calls 740 and is all-in
Rhea242: folds 
Little O56: folds 
mariocai: folds 
Uncalled bet (1060) returned to Taargeett
*** FLOP *** [9h 5c 2h]
*** TURN *** [9h 5c 2h] [8h]
*** RIVER *** [9h 5c 2h 8h] [8d]
*** SHOW DOWN ***
Taargeett: shows [Ts Tc] (two pair, Tens and Eights)
cant_remembr: shows [9d As] (two pair, Nines and Eights)
Taargeett collected 2830 from pot
cant_remembr finished the tournament in 100th place and received 9400.
*** SUMMARY ***
Total pot 2830 | Rake 0 
Board [9h 5c 2h 8h 8d]
Seat 1: Rhea242 (button) folded before Flop (didn't bet)
Seat 2: Little O56 (small blind) folded before Flop
Seat 3: mariocai (big blind) folded before Flop
Seat 4: hernan646 folded before Flop (didn't bet)
Seat 5: dan399 folded before Flop (didn't bet)
Seat 6: KingTT1 folded before Flop (didn't bet)
Seat 7: Taargeett showed [Ts Tc] and won (2830) with two pair, Tens and Eights
Seat 8: serrot27 folded before Flop (didn't bet)
Seat 9: cant_remembr showed [9d As] and lost with two pair, Nines and Eights



PokerStars Hand #201497838962: Tournament #2629783708, 8700+1300 Hold'em No Limit - Level X (300/600) - 2019/06/17 22:54:03 ET
Table '2629783708 20' 9-max Seat #6 is the button
Seat 1: railbird73 (6540 in chips) 
Seat 2: Taargeett (11306 in chips) 
Seat 3: _Yxz99 (1223 in chips) 
Seat 4: skinchamp (16981 in chips) 
Seat 6: Cooki2759 (12859 in chips) 
Seat 7: HeavenPSward (3525 in chips) is sitting out
Seat 8: KingTT1 (12327 in chips) 
Seat 9: KATYBOSS (8444 in chips) 
railbird73: posts the ante 50
Taargeett: posts the ante 50
_Yxz99: posts the ante 50
skinchamp: posts the ante 50
Cooki2759: posts the ante 50
HeavenPSward: posts the ante 50
KingTT1: posts the ante 50
KATYBOSS: posts the ante 50
HeavenPSward: posts small blind 300
KingTT1: posts big blind 600
*** HOLE CARDS ***
Dealt to Taargeett [8s Qc]
KATYBOSS: folds 
railbird73: folds 
Taargeett: folds 
_Yxz99: raises 573 to 1173 and is all-in
skinchamp: folds 
Cooki2759: folds 
HeavenPSward: folds 
KingTT1: calls 573
*** FLOP *** [9c 9h 7s]
*** TURN *** [9c 9h 7s] [Ks]
*** RIVER *** [9c 9h 7s Ks] [Tc]
*** SHOW DOWN ***
KingTT1: shows [5c Ad] (a pair of Nines)
_Yxz99: shows [Td Jc] (two pair, Tens and Nines)
_Yxz99 collected 3046 from pot
*** SUMMARY ***
Total pot 3046 | Rake 0 
Board [9c 9h 7s Ks Tc]
Seat 1: railbird73 folded before Flop (didn't bet)
Seat 2: Taargeett folded before Flop (didn't bet)
Seat 3: _Yxz99 showed [Td Jc] and won (3046) with two pair, Tens and Nines
Seat 4: skinchamp folded before Flop (didn't bet)
Seat 6: Cooki2759 (button) folded before Flop (didn't bet)
Seat 7: HeavenPSward (small blind) folded before Flop
Seat 8: KingTT1 (big blind) showed [5c Ad] and lost with a pair of Nines
Seat 9: KATYBOSS folded before Flop (didn't bet)



PokerStars Hand #201497847811: Tournament #2629783708, 8700+1300 Hold'em No Limit - Level X (300/600) - 2019/06/17 22:54:45 ET
Table '2629783708 20' 9-max Seat #7 is the button
Seat 1: railbird73 (6490 in chips) 
Seat 2: Taargeett (11256 in chips) 
Seat 3: _Yxz99 (3046 in chips) 
Seat 4: skinchamp (16931 in chips) 
Seat 6: Cooki2759 (12809 in chips) 
Seat 7: HeavenPSward (3175 in chips) is sitting out
Seat 8: KingTT1 (11104 in chips) 
Seat 9: KATYBOSS (8394 in chips) 
railbird73: posts the ante 50
Taargeett: posts the ante 50
_Yxz99: posts the ante 50
skinchamp: posts the ante 50
Cooki2759: posts the ante 50
HeavenPSward: posts the ante 50
KingTT1: posts the ante 50
KATYBOSS: posts the ante 50
KingTT1: posts small blind 300
KATYBOSS: posts big blind 600
*** HOLE CARDS ***
Dealt to Taargeett [Qc Ad]
railbird73: folds 
Taargeett: raises 600 to 1200
_Yxz99: raises 1796 to 2996 and is all-in
skinchamp: folds 
Cooki2759: folds 
HeavenPSward: raises 129 to 3125 and is all-in
KingTT1: folds 
KATYBOSS: folds 
Taargeett: calls 1925
*** FLOP *** [4d As Qd]
*** TURN *** [4d As Qd] [8d]
*** RIVER *** [4d As Qd 8d] [3d]
*** SHOW DOWN ***
Taargeett: shows [Qc Ad] (a flush, Ace high)
HeavenPSward: shows [Ah 9s] (a pair of Aces)
Taargeett collected 258 from side pot
_Yxz99: shows [Ts Kd] (a flush, King high)
Taargeett collected 10288 from main pot
HeavenPSward finished the tournament in 89th place and received 10700.
_Yxz99 finished the tournament in 90th place and received 10700.
*** SUMMARY ***
Total pot 10546 Main pot 10288. Side pot 258. | Rake 0 
Board [4d As Qd 8d 3d]
Seat 1: railbird73 folded before Flop (didn't bet)
Seat 2: Taargeett showed [Qc Ad] and won (10546) with a flush, Ace high
Seat 3: _Yxz99 showed [Ts Kd] and lost with a flush, King high
Seat 4: skinchamp folded before Flop (didn't bet)
Seat 6: Cooki2759 folded before Flop (didn't bet)
Seat 7: HeavenPSward (button) showed [Ah 9s] and lost with a pair of Aces
Seat 8: KingTT1 (small blind) folded before Flop
Seat 9: KATYBOSS (big blind) folded before Flop



PokerStars Hand #201497931576: Tournament #2629783708, 8700+1300 Hold'em No Limit - Level XI (400/800) - 2019/06/17 23:01:25 ET
Table '2629783708 20' 9-max Seat #8 is the button
Seat 1: railbird73 (6440 in chips) 
Seat 2: Taargeett (18627 in chips) 
Seat 3: surf@losteri (13558 in chips) 
Seat 4: skinchamp (16881 in chips) 
Seat 5: POPOPS2010 (3700 in chips) 
Seat 6: Cooki2759 (12759 in chips) 
Seat 8: KingTT1 (10754 in chips) 
Seat 9: KATYBOSS (7744 in chips) 
railbird73: posts the ante 75
Taargeett: posts the ante 75
surf@losteri: posts the ante 75
skinchamp: posts the ante 75
POPOPS2010: posts the ante 75
Cooki2759: posts the ante 75
KingTT1: posts the ante 75
KATYBOSS: posts the ante 75
KATYBOSS: posts small blind 400
railbird73: posts big blind 800
*** HOLE CARDS ***
Dealt to Taargeett [Jd 7s]
Taargeett: folds 
surf@losteri has timed out while disconnected
surf@losteri: folds 
skinchamp: raises 800 to 1600
POPOPS2010: folds 
Cooki2759: calls 1600
KingTT1: folds 
KATYBOSS has timed out
KATYBOSS: folds 
railbird73: calls 800
*** FLOP *** [Qh 3d 7c]
railbird73: checks 
skinchamp: checks 
Cooki2759: checks 
*** TURN *** [Qh 3d 7c] [2s]
railbird73: checks 
skinchamp: checks 
Cooki2759: checks 
*** RIVER *** [Qh 3d 7c 2s] [Ad]
railbird73: checks 
skinchamp: checks 
Cooki2759: bets 2900
railbird73: folds 
skinchamp: folds 
Uncalled bet (2900) returned to Cooki2759
Cooki2759 collected 5800 from pot
Cooki2759: doesn't show hand 
*** SUMMARY ***
Total pot 5800 | Rake 0 
Board [Qh 3d 7c 2s Ad]
Seat 1: railbird73 (big blind) folded on the River
Seat 2: Taargeett folded before Flop (didn't bet)
Seat 3: surf@losteri folded before Flop (didn't bet)
Seat 4: skinchamp folded on the River
Seat 5: POPOPS2010 folded before Flop (didn't bet)
Seat 6: Cooki2759 collected (5800)
Seat 8: KingTT1 (button) folded before Flop (didn't bet)
Seat 9: KATYBOSS (small blind) folded before Flop



PokerStars Hand #201497949311: Tournament #2629783708, 8700+1300 Hold'em No Limit - Level XI (400/800) - 2019/06/17 23:02:50 ET
Table '2629783708 20' 9-max Seat #9 is the button
Seat 1: railbird73 (4765 in chips) 
Seat 2: Taargeett (18552 in chips) 
Seat 3: surf@losteri (13483 in chips) is sitting out
Seat 4: skinchamp (15206 in chips) 
Seat 5: POPOPS2010 (3625 in chips) 
Seat 6: Cooki2759 (16884 in chips) 
Seat 8: KingTT1 (10679 in chips) 
Seat 9: KATYBOSS (7269 in chips) is sitting out
railbird73: posts the ante 75
Taargeett: posts the ante 75
surf@losteri: posts the ante 75
skinchamp: posts the ante 75
POPOPS2010: posts the ante 75
Cooki2759: posts the ante 75
KingTT1: posts the ante 75
KATYBOSS: posts the ante 75
railbird73: posts small blind 400
Taargeett: posts big blind 800
*** HOLE CARDS ***
Dealt to Taargeett [Qh 8h]
surf@losteri: folds 
skinchamp: raises 800 to 1600
POPOPS2010: calls 1600
Cooki2759: folds 
KingTT1: folds 
KATYBOSS: folds 
railbird73: calls 1200
Taargeett: folds 
*** FLOP *** [Kc Td 7c]
railbird73: checks 
skinchamp: bets 1600
POPOPS2010: raises 350 to 1950 and is all-in
railbird73: folds 
skinchamp: calls 350
*** TURN *** [Kc Td 7c] [Jh]
*** RIVER *** [Kc Td 7c Jh] [Kd]
*** SHOW DOWN ***
skinchamp: shows [Js Ts] (two pair, Kings and Jacks)
POPOPS2010: shows [4h 4d] (two pair, Kings and Fours)
skinchamp collected 10100 from pot
POPOPS2010 finished the tournament in 81st place and received 11600.
*** SUMMARY ***
Total pot 10100 | Rake 0 
Board [Kc Td 7c Jh Kd]
Seat 1: railbird73 (small blind) folded on the Flop
Seat 2: Taargeett (big blind) folded before Flop
Seat 3: surf@losteri folded before Flop (didn't bet)
Seat 4: skinchamp showed [Js Ts] and won (10100) with two pair, Kings and Jacks
Seat 5: POPOPS2010 showed [4h 4d] and lost with two pair, Kings and Fours
Seat 6: Cooki2759 folded before Flop (didn't bet)
Seat 8: KingTT1 folded before Flop (didn't bet)
Seat 9: KATYBOSS (button) folded before Flop (didn't bet)



PokerStars Hand #201497959597: Tournament #2629783708, 8700+1300 Hold'em No Limit - Level XI (400/800) - 2019/06/17 23:03:39 ET
Table '2629783708 20' 9-max Seat #1 is the button
Seat 1: railbird73 (3090 in chips) 
Seat 2: Taargeett (17677 in chips) 
Seat 3: surf@losteri (13408 in chips) is sitting out
Seat 4: skinchamp (21681 in chips) 
Seat 6: Cooki2759 (16809 in chips) 
Seat 7: maicon7k (23442 in chips) 
Seat 8: KingTT1 (10604 in chips) 
Seat 9: KATYBOSS (7194 in chips) 
railbird73: posts the ante 75
Taargeett: posts the ante 75
surf@losteri: posts the ante 75
skinchamp: posts the ante 75
Cooki2759: posts the ante 75
maicon7k: posts the ante 75
KingTT1: posts the ante 75
KATYBOSS: posts the ante 75
Taargeett: posts small blind 400
surf@losteri: posts big blind 800
*** HOLE CARDS ***
Dealt to Taargeett [2c 8c]
skinchamp: folds 
Cooki2759: folds 
maicon7k: folds 
KingTT1: folds 
KATYBOSS: folds 
railbird73: folds 
Taargeett: raises 800 to 1600
surf@losteri: folds 
Uncalled bet (800) returned to Taargeett
Taargeett collected 2200 from pot
Taargeett: doesn't show hand 
*** SUMMARY ***
Total pot 2200 | Rake 0 
Seat 1: railbird73 (button) folded before Flop (didn't bet)
Seat 2: Taargeett (small blind) collected (2200)
Seat 3: surf@losteri (big blind) folded before Flop
Seat 4: skinchamp folded before Flop (didn't bet)
Seat 6: Cooki2759 folded before Flop (didn't bet)
Seat 7: maicon7k folded before Flop (didn't bet)
Seat 8: KingTT1 folded before Flop (didn't bet)
Seat 9: KATYBOSS folded before Flop (didn't bet)



PokerStars Hand #201497964078: Tournament #2629783708, 8700+1300 Hold'em No Limit - Level XI (400/800) - 2019/06/17 23:04:00 ET
Table '2629783708 20' 9-max Seat #2 is the button
Seat 1: railbird73 (3015 in chips) 
Seat 2: Taargeett (19002 in chips) 
Seat 3: surf@losteri (12533 in chips) is sitting out
Seat 4: skinchamp (21606 in chips) 
Seat 6: Cooki2759 (16734 in chips) 
Seat 7: maicon7k (23367 in chips) 
Seat 8: KingTT1 (10529 in chips) 
Seat 9: KATYBOSS (7119 in chips) 
railbird73: posts the ante 75
Taargeett: posts the ante 75
surf@losteri: posts the ante 75
skinchamp: posts the ante 75
Cooki2759: posts the ante 75
maicon7k: posts the ante 75
KingTT1: posts the ante 75
KATYBOSS: posts the ante 75
surf@losteri: posts small blind 400
skinchamp: posts big blind 800
*** HOLE CARDS ***
Dealt to Taargeett [8h Ac]
Cooki2759: folds 
maicon7k: folds 
KingTT1: folds 
KATYBOSS: folds 
railbird73: folds 
Taargeett: folds 
surf@losteri: folds 
Uncalled bet (400) returned to skinchamp
skinchamp collected 1400 from pot
*** SUMMARY ***
Total pot 1400 | Rake 0 
Seat 1: railbird73 folded before Flop (didn't bet)
Seat 2: Taargeett (button) folded before Flop (didn't bet)
Seat 3: surf@losteri (small blind) folded before Flop
Seat 4: skinchamp (big blind) collected (1400)
Seat 6: Cooki2759 folded before Flop (didn't bet)
Seat 7: maicon7k folded before Flop (didn't bet)
Seat 8: KingTT1 folded before Flop (didn't bet)
Seat 9: KATYBOSS folded before Flop (didn't bet)



PokerStars Hand #201497967147: Tournament #2629783708, 8700+1300 Hold'em No Limit - Level XI (400/800) - 2019/06/17 23:04:14 ET
Table '2629783708 20' 9-max Seat #3 is the button
Seat 1: railbird73 (2940 in chips) 
Seat 2: Taargeett (18927 in chips) 
Seat 3: surf@losteri (12058 in chips) is sitting out
Seat 4: skinchamp (22531 in chips) 
Seat 6: Cooki2759 (16659 in chips) 
Seat 7: maicon7k (23292 in chips) 
Seat 8: KingTT1 (10454 in chips) 
Seat 9: KATYBOSS (7044 in chips) 
railbird73: posts the ante 75
Taargeett: posts the ante 75
surf@losteri: posts the ante 75
skinchamp: posts the ante 75
Cooki2759: posts the ante 75
maicon7k: posts the ante 75
KingTT1: posts the ante 75
KATYBOSS: posts the ante 75
skinchamp: posts small blind 400
Cooki2759: posts big blind 800
*** HOLE CARDS ***
Dealt to Taargeett [8d 4c]
maicon7k: folds 
KingTT1: folds 
KATYBOSS: raises 800 to 1600
railbird73: folds 
Taargeett: folds 
surf@losteri: folds 
skinchamp: calls 1200
Cooki2759: calls 800
*** FLOP *** [7s 3c Qc]
skinchamp: checks 
Cooki2759: checks 
KATYBOSS: bets 5369 and is all-in
skinchamp: folds 
Cooki2759: folds 
Uncalled bet (5369) returned to KATYBOSS
KATYBOSS collected 5400 from pot
*** SUMMARY ***
Total pot 5400 | Rake 0 
Board [7s 3c Qc]
Seat 1: railbird73 folded before Flop (didn't bet)
Seat 2: Taargeett folded before Flop (didn't bet)
Seat 3: surf@losteri (button) folded before Flop (didn't bet)
Seat 4: skinchamp (small blind) folded on the Flop
Seat 6: Cooki2759 (big blind) folded on the Flop
Seat 7: maicon7k folded before Flop (didn't bet)
Seat 8: KingTT1 folded before Flop (didn't bet)
Seat 9: KATYBOSS collected (5400)



PokerStars Hand #201497973994: Tournament #2629783708, 8700+1300 Hold'em No Limit - Level XI (400/800) - 2019/06/17 23:04:47 ET
Table '2629783708 20' 9-max Seat #4 is the button
Seat 1: railbird73 (2865 in chips) 
Seat 2: Taargeett (18852 in chips) 
Seat 3: surf@losteri (11983 in chips) is sitting out
Seat 4: skinchamp (20856 in chips) 
Seat 6: Cooki2759 (14984 in chips) 
Seat 7: maicon7k (23217 in chips) 
Seat 8: KingTT1 (10379 in chips) 
Seat 9: KATYBOSS (10769 in chips) 
railbird73: posts the ante 75
Taargeett: posts the ante 75
surf@losteri: posts the ante 75
skinchamp: posts the ante 75
Cooki2759: posts the ante 75
maicon7k: posts the ante 75
KingTT1: posts the ante 75
KATYBOSS: posts the ante 75
Cooki2759: posts small blind 400
maicon7k: posts big blind 800
*** HOLE CARDS ***
Dealt to Taargeett [5h 3c]
KingTT1: folds 
KATYBOSS: folds 
railbird73: calls 800
Taargeett: folds 
surf@losteri: folds 
skinchamp: folds 
Cooki2759: folds 
maicon7k: checks 
*** FLOP *** [7h Kc 6c]
maicon7k: checks 
railbird73: checks 
*** TURN *** [7h Kc 6c] [5c]
maicon7k: bets 800
railbird73: folds 
Uncalled bet (800) returned to maicon7k
maicon7k collected 2600 from pot
maicon7k: doesn't show hand 
*** SUMMARY ***
Total pot 2600 | Rake 0 
Board [7h Kc 6c 5c]
Seat 1: railbird73 folded on the Turn
Seat 2: Taargeett folded before Flop (didn't bet)
Seat 3: surf@losteri folded before Flop (didn't bet)
Seat 4: skinchamp (button) folded before Flop (didn't bet)
Seat 6: Cooki2759 (small blind) folded before Flop
Seat 7: maicon7k (big blind) collected (2600)
Seat 8: KingTT1 folded before Flop (didn't bet)
Seat 9: KATYBOSS folded before Flop (didn't bet)



PokerStars Hand #201497982437: Tournament #2629783708, 8700+1300 Hold'em No Limit - Level XI (400/800) - 2019/06/17 23:05:28 ET
Table '2629783708 20' 9-max Seat #6 is the button
Seat 1: railbird73 (1990 in chips) 
Seat 2: Taargeett (18777 in chips) 
Seat 3: surf@losteri (11908 in chips) is sitting out
Seat 4: skinchamp (20781 in chips) 
Seat 5: pigzilla01 (3000 in chips) 
Seat 6: Cooki2759 (14509 in chips) 
Seat 7: maicon7k (24942 in chips) 
Seat 8: KingTT1 (10304 in chips) 
Seat 9: KATYBOSS (10694 in chips) 
railbird73: posts the ante 75
Taargeett: posts the ante 75
surf@losteri: posts the ante 75
skinchamp: posts the ante 75
pigzilla01: posts the ante 75
Cooki2759: posts the ante 75
maicon7k: posts the ante 75
KingTT1: posts the ante 75
KATYBOSS: posts the ante 75
maicon7k: posts small blind 400
KingTT1: posts big blind 800
*** HOLE CARDS ***
Dealt to Taargeett [7h Ts]
KATYBOSS: folds 
railbird73: folds 
Taargeett: folds 
surf@losteri: folds 
skinchamp: raises 1600 to 2400
pigzilla01: folds 
Cooki2759: folds 
maicon7k: folds 
KingTT1: folds 
Uncalled bet (1600) returned to skinchamp
skinchamp collected 2675 from pot
*** SUMMARY ***
Total pot 2675 | Rake 0 
Seat 1: railbird73 folded before Flop (didn't bet)
Seat 2: Taargeett folded before Flop (didn't bet)
Seat 3: surf@losteri folded before Flop (didn't bet)
Seat 4: skinchamp collected (2675)
Seat 5: pigzilla01 folded before Flop (didn't bet)
Seat 6: Cooki2759 (button) folded before Flop (didn't bet)
Seat 7: maicon7k (small blind) folded before Flop
Seat 8: KingTT1 (big blind) folded before Flop
Seat 9: KATYBOSS folded before Flop (didn't bet)



PokerStars Hand #201497988613: Tournament #2629783708, 8700+1300 Hold'em No Limit - Level XI (400/800) - 2019/06/17 23:05:57 ET
Table '2629783708 20' 9-max Seat #7 is the button
Seat 1: railbird73 (1915 in chips) 
Seat 2: Taargeett (18702 in chips) 
Seat 3: surf@losteri (11833 in chips) is sitting out
Seat 4: skinchamp (22581 in chips) 
Seat 6: Cooki2759 (14434 in chips) 
Seat 7: maicon7k (24467 in chips) 
Seat 8: KingTT1 (9429 in chips) 
Seat 9: KATYBOSS (10619 in chips) 
railbird73: posts the ante 75
Taargeett: posts the ante 75
surf@losteri: posts the ante 75
skinchamp: posts the ante 75
Cooki2759: posts the ante 75
maicon7k: posts the ante 75
KingTT1: posts the ante 75
KATYBOSS: posts the ante 75
KingTT1: posts small blind 400
KATYBOSS: posts big blind 800
*** HOLE CARDS ***
Dealt to Taargeett [4c 6h]
railbird73: folds 
Taargeett: folds 
surf@losteri: folds 
skinchamp: calls 800
Cooki2759: folds 
maicon7k: folds 
KingTT1: calls 400
KATYBOSS: checks 
*** FLOP *** [Jh 6c Kd]
KingTT1: checks 
KATYBOSS: bets 1600
skinchamp: folds 
KingTT1: folds 
Uncalled bet (1600) returned to KATYBOSS
KATYBOSS collected 3000 from pot
*** SUMMARY ***
Total pot 3000 | Rake 0 
Board [Jh 6c Kd]
Seat 1: railbird73 folded before Flop (didn't bet)
Seat 2: Taargeett folded before Flop (didn't bet)
Seat 3: surf@losteri folded before Flop (didn't bet)
Seat 4: skinchamp folded on the Flop
Seat 6: Cooki2759 folded before Flop (didn't bet)
Seat 7: maicon7k (button) folded before Flop (didn't bet)
Seat 8: KingTT1 (small blind) folded on the Flop
Seat 9: KATYBOSS (big blind) collected (3000)



PokerStars Hand #201497996699: Tournament #2629783708, 8700+1300 Hold'em No Limit - Level XII (500/1000) - 2019/06/17 23:06:36 ET
Table '2629783708 20' 9-max Seat #8 is the button
Seat 1: railbird73 (1840 in chips) 
Seat 2: Taargeett (18627 in chips) 
Seat 3: surf@losteri (11758 in chips) is sitting out
Seat 4: skinchamp (21706 in chips) 
Seat 6: Cooki2759 (14359 in chips) 
Seat 7: maicon7k (24392 in chips) 
Seat 8: KingTT1 (8554 in chips) 
Seat 9: KATYBOSS (12744 in chips) 
railbird73: posts the ante 100
Taargeett: posts the ante 100
surf@losteri: posts the ante 100
skinchamp: posts the ante 100
Cooki2759: posts the ante 100
maicon7k: posts the ante 100
KingTT1: posts the ante 100
KATYBOSS: posts the ante 100
KATYBOSS: posts small blind 500
railbird73: posts big blind 1000
*** HOLE CARDS ***
Dealt to Taargeett [Js 5c]
Taargeett: folds 
surf@losteri: folds 
skinchamp: folds 
Cooki2759: folds 
maicon7k: folds 
KingTT1: folds 
KATYBOSS: calls 500
railbird73: checks 
*** FLOP *** [Jd 4s Kh]
KATYBOSS: bets 1000
railbird73: folds 
Uncalled bet (1000) returned to KATYBOSS
KATYBOSS collected 2800 from pot
*** SUMMARY ***
Total pot 2800 | Rake 0 
Board [Jd 4s Kh]
Seat 1: railbird73 (big blind) folded on the Flop
Seat 2: Taargeett folded before Flop (didn't bet)
Seat 3: surf@losteri folded before Flop (didn't bet)
Seat 4: skinchamp folded before Flop (didn't bet)
Seat 6: Cooki2759 folded before Flop (didn't bet)
Seat 7: maicon7k folded before Flop (didn't bet)
Seat 8: KingTT1 (button) folded before Flop (didn't bet)
Seat 9: KATYBOSS (small blind) collected (2800)



PokerStars Hand #201498003315: Tournament #2629783708, 8700+1300 Hold'em No Limit - Level XII (500/1000) - 2019/06/17 23:07:07 ET
Table '2629783708 20' 9-max Seat #9 is the button
Seat 1: railbird73 (740 in chips) 
Seat 2: Taargeett (18527 in chips) 
Seat 3: surf@losteri (11658 in chips) is sitting out
Seat 4: skinchamp (21606 in chips) 
Seat 6: Cooki2759 (14259 in chips) 
Seat 7: maicon7k (24292 in chips) 
Seat 8: KingTT1 (8454 in chips) 
Seat 9: KATYBOSS (14444 in chips) 
railbird73: posts the ante 100
Taargeett: posts the ante 100
surf@losteri: posts the ante 100
skinchamp: posts the ante 100
Cooki2759: posts the ante 100
maicon7k: posts the ante 100
KingTT1: posts the ante 100
KATYBOSS: posts the ante 100
railbird73: posts small blind 500
Taargeett: posts big blind 1000
*** HOLE CARDS ***
Dealt to Taargeett [Tc Ac]
surf@losteri: folds 
skinchamp: folds 
Cooki2759: raises 1000 to 2000
maicon7k: folds 
KingTT1: folds 
KATYBOSS: folds 
railbird73: calls 140 and is all-in
Taargeett: raises 16427 to 18427 and is all-in
Cooki2759: folds 
Uncalled bet (16427) returned to Taargeett
*** FLOP *** [Ad Kc Ah]
*** TURN *** [Ad Kc Ah] [7c]
*** RIVER *** [Ad Kc Ah 7c] [7s]
*** SHOW DOWN ***
Taargeett: shows [Tc Ac] (a full house, Aces full of Sevens)
Taargeett collected 2720 from side pot
railbird73: shows [3d Jh] (two pair, Aces and Sevens)
Taargeett collected 2720 from main pot
railbird73 finished the tournament in 65th place and received 12500.
*** SUMMARY ***
Total pot 5440 Main pot 2720. Side pot 2720. | Rake 0 
Board [Ad Kc Ah 7c 7s]
Seat 1: railbird73 (small blind) showed [3d Jh] and lost with two pair, Aces and Sevens
Seat 2: Taargeett (big blind) showed [Tc Ac] and won (5440) with a full house, Aces full of Sevens
Seat 3: surf@losteri folded before Flop (didn't bet)
Seat 4: skinchamp folded before Flop (didn't bet)
Seat 6: Cooki2759 folded before Flop
Seat 7: maicon7k folded before Flop (didn't bet)
Seat 8: KingTT1 folded before Flop (didn't bet)
Seat 9: KATYBOSS (button) folded before Flop (didn't bet)



PokerStars Hand #201498013268: Tournament #2629783708, 8700+1300 Hold'em No Limit - Level XII (500/1000) - 2019/06/17 23:07:55 ET
Table '2629783708 20' 9-max Seat #2 is the button
Seat 2: Taargeett (21867 in chips) 
Seat 3: surf@losteri (11558 in chips) is sitting out
Seat 4: skinchamp (21506 in chips) 
Seat 6: Cooki2759 (12159 in chips) 
Seat 7: maicon7k (24192 in chips) 
Seat 8: KingTT1 (8354 in chips) 
Seat 9: KATYBOSS (14344 in chips) 
Taargeett: posts the ante 100
surf@losteri: posts the ante 100
skinchamp: posts the ante 100
Cooki2759: posts the ante 100
maicon7k: posts the ante 100
KingTT1: posts the ante 100
KATYBOSS: posts the ante 100
surf@losteri: posts small blind 500
skinchamp: posts big blind 1000
*** HOLE CARDS ***
Dealt to Taargeett [Tc 2s]
Cooki2759: folds 
maicon7k: raises 1000 to 2000
KingTT1: folds 
KATYBOSS: folds 
Taargeett: folds 
surf@losteri: folds 
skinchamp: calls 1000
*** FLOP *** [4c 9d Jc]
skinchamp: checks 
maicon7k: bets 2000
skinchamp: calls 2000
*** TURN *** [4c 9d Jc] [6d]
skinchamp: checks 
maicon7k: checks 
*** RIVER *** [4c 9d Jc 6d] [7c]
skinchamp: checks 
maicon7k: bets 4000
skinchamp: folds 
Uncalled bet (4000) returned to maicon7k
maicon7k collected 9200 from pot
maicon7k: doesn't show hand 
*** SUMMARY ***
Total pot 9200 | Rake 0 
Board [4c 9d Jc 6d 7c]
Seat 2: Taargeett (button) folded before Flop (didn't bet)
Seat 3: surf@losteri (small blind) folded before Flop
Seat 4: skinchamp (big blind) folded on the River
Seat 6: Cooki2759 folded before Flop (didn't bet)
Seat 7: maicon7k collected (9200)
Seat 8: KingTT1 folded before Flop (didn't bet)
Seat 9: KATYBOSS folded before Flop (didn't bet)



PokerStars Hand #201498020923: Tournament #2629783708, 8700+1300 Hold'em No Limit - Level XII (500/1000) - 2019/06/17 23:08:32 ET
Table '2629783708 20' 9-max Seat #3 is the button
Seat 1: UdsNoExisten (9898 in chips) 
Seat 2: Taargeett (21767 in chips) 
Seat 3: surf@losteri (10958 in chips) is sitting out
Seat 4: skinchamp (17406 in chips) 
Seat 5: Rhea242 (11135 in chips) 
Seat 6: Cooki2759 (12059 in chips) 
Seat 7: maicon7k (29292 in chips) 
Seat 8: KingTT1 (8254 in chips) 
Seat 9: KATYBOSS (14244 in chips) 
UdsNoExisten: posts the ante 100
Taargeett: posts the ante 100
surf@losteri: posts the ante 100
skinchamp: posts the ante 100
Rhea242: posts the ante 100
Cooki2759: posts the ante 100
maicon7k: posts the ante 100
KingTT1: posts the ante 100
KATYBOSS: posts the ante 100
skinchamp: posts small blind 500
Rhea242: posts big blind 1000
*** HOLE CARDS ***
Dealt to Taargeett [7c 3h]
Cooki2759: folds 
maicon7k: folds 
KingTT1: folds 
KATYBOSS: folds 
UdsNoExisten: raises 8798 to 9798 and is all-in
Taargeett: folds 
surf@losteri: folds 
skinchamp: folds 
Rhea242: calls 8798
*** FLOP *** [2h Kh 8d]
*** TURN *** [2h Kh 8d] [2d]
*** RIVER *** [2h Kh 8d 2d] [Kc]
*** SHOW DOWN ***
Rhea242: shows [Qh Qs] (two pair, Kings and Queens)
UdsNoExisten: shows [Tc Th] (two pair, Kings and Tens)
Rhea242 collected 20996 from pot
UdsNoExisten finished the tournament in 61st place and received 13400.
*** SUMMARY ***
Total pot 20996 | Rake 0 
Board [2h Kh 8d 2d Kc]
Seat 1: UdsNoExisten showed [Tc Th] and lost with two pair, Kings and Tens
Seat 2: Taargeett folded before Flop (didn't bet)
Seat 3: surf@losteri (button) folded before Flop (didn't bet)
Seat 4: skinchamp (small blind) folded before Flop
Seat 5: Rhea242 (big blind) showed [Qh Qs] and won (20996) with two pair, Kings and Queens
Seat 6: Cooki2759 folded before Flop (didn't bet)
Seat 7: maicon7k folded before Flop (didn't bet)
Seat 8: KingTT1 folded before Flop (didn't bet)
Seat 9: KATYBOSS folded before Flop (didn't bet)



PokerStars Hand #201498028730: Tournament #2629783708, 8700+1300 Hold'em No Limit - Level XII (500/1000) - 2019/06/17 23:09:10 ET
Table '2629783708 20' 9-max Seat #4 is the button
Seat 2: Taargeett (21667 in chips) 
Seat 3: surf@losteri (10858 in chips) is sitting out
Seat 4: skinchamp (16806 in chips) 
Seat 5: Rhea242 (22233 in chips) 
Seat 6: Cooki2759 (11959 in chips) 
Seat 7: maicon7k (29192 in chips) 
Seat 8: KingTT1 (8154 in chips) 
Seat 9: KATYBOSS (14144 in chips) 
Taargeett: posts the ante 100
surf@losteri: posts the ante 100
skinchamp: posts the ante 100
Rhea242: posts the ante 100
Cooki2759: posts the ante 100
maicon7k: posts the ante 100
KingTT1: posts the ante 100
KATYBOSS: posts the ante 100
Rhea242: posts small blind 500
Cooki2759: posts big blind 1000
*** HOLE CARDS ***
Dealt to Taargeett [Kd 3d]
maicon7k: folds 
KingTT1: folds 
KATYBOSS: folds 
Taargeett: folds 
surf@losteri: folds 
skinchamp: raises 3300 to 4300
Rhea242: folds 
Cooki2759: folds 
Uncalled bet (3300) returned to skinchamp
skinchamp collected 3300 from pot
*** SUMMARY ***
Total pot 3300 | Rake 0 
Seat 2: Taargeett folded before Flop (didn't bet)
Seat 3: surf@losteri folded before Flop (didn't bet)
Seat 4: skinchamp (button) collected (3300)
Seat 5: Rhea242 (small blind) folded before Flop
Seat 6: Cooki2759 (big blind) folded before Flop
Seat 7: maicon7k folded before Flop (didn't bet)
Seat 8: KingTT1 folded before Flop (didn't bet)
Seat 9: KATYBOSS folded before Flop (didn't bet)



PokerStars Hand #201498035148: Tournament #2629783708, 8700+1300 Hold'em No Limit - Level XII (500/1000) - 2019/06/17 23:09:42 ET
Table '2629783708 20' 9-max Seat #5 is the button
Seat 2: Taargeett (21567 in chips) 
Seat 3: surf@losteri (10758 in chips) is sitting out
Seat 4: skinchamp (19006 in chips) 
Seat 5: Rhea242 (21633 in chips) 
Seat 6: Cooki2759 (10859 in chips) 
Seat 7: maicon7k (29092 in chips) 
Seat 8: KingTT1 (8054 in chips) 
Seat 9: KATYBOSS (14044 in chips) 
Taargeett: posts the ante 100
surf@losteri: posts the ante 100
skinchamp: posts the ante 100
Rhea242: posts the ante 100
Cooki2759: posts the ante 100
maicon7k: posts the ante 100
KingTT1: posts the ante 100
KATYBOSS: posts the ante 100
Cooki2759: posts small blind 500
maicon7k: posts big blind 1000
*** HOLE CARDS ***
Dealt to Taargeett [2s 8s]
KingTT1 has timed out
KingTT1: folds 
KATYBOSS: calls 1000
Taargeett: folds 
surf@losteri: folds 
skinchamp: folds 
Rhea242: folds 
Cooki2759: calls 500
maicon7k: checks 
*** FLOP *** [7h 2c 6d]
Cooki2759: bets 1000
maicon7k: raises 3000 to 4000
KATYBOSS: calls 4000
Cooki2759: calls 3000
*** TURN *** [7h 2c 6d] [Ad]
Cooki2759: checks 
maicon7k: checks 
KATYBOSS: checks 
*** RIVER *** [7h 2c 6d Ad] [Qd]
Cooki2759: checks 
maicon7k: checks 
KATYBOSS: checks 
*** SHOW DOWN ***
Cooki2759: shows [3c 4h] (high card Ace)
maicon7k: shows [7s 3h] (a pair of Sevens)
KATYBOSS: mucks hand 
maicon7k collected 15800 from pot
*** SUMMARY ***
Total pot 15800 | Rake 0 
Board [7h 2c 6d Ad Qd]
Seat 2: Taargeett folded before Flop (didn't bet)
Seat 3: surf@losteri folded before Flop (didn't bet)
Seat 4: skinchamp folded before Flop (didn't bet)
Seat 5: Rhea242 (button) folded before Flop (didn't bet)
Seat 6: Cooki2759 (small blind) showed [3c 4h] and lost with high card Ace
Seat 7: maicon7k (big blind) showed [7s 3h] and won (15800) with a pair of Sevens
Seat 8: KingTT1 folded before Flop (didn't bet)
Seat 9: KATYBOSS mucked [9h 8h]



PokerStars Hand #201498049100: Tournament #2629783708, 8700+1300 Hold'em No Limit - Level XII (500/1000) - 2019/06/17 23:10:49 ET
Table '2629783708 20' 9-max Seat #6 is the button
Seat 1: mmaatthh (13483 in chips) 
Seat 2: Taargeett (21467 in chips) 
Seat 3: surf@losteri (10658 in chips) is sitting out
Seat 4: skinchamp (18906 in chips) 
Seat 5: Rhea242 (21533 in chips) 
Seat 6: Cooki2759 (5759 in chips) 
Seat 7: maicon7k (39792 in chips) 
Seat 8: KingTT1 (7954 in chips) 
Seat 9: KATYBOSS (8944 in chips) 
mmaatthh: posts the ante 100
Taargeett: posts the ante 100
surf@losteri: posts the ante 100
skinchamp: posts the ante 100
Rhea242: posts the ante 100
Cooki2759: posts the ante 100
maicon7k: posts the ante 100
KingTT1: posts the ante 100
KATYBOSS: posts the ante 100
maicon7k: posts small blind 500
KingTT1: posts big blind 1000
*** HOLE CARDS ***
Dealt to Taargeett [8d 5h]
KATYBOSS: calls 1000
mmaatthh: folds 
Taargeett: folds 
surf@losteri: folds 
skinchamp: folds 
Rhea242: folds 
Cooki2759: folds 
maicon7k: calls 500
KingTT1: checks 
*** FLOP *** [8c 6s Th]
maicon7k: bets 1000
KingTT1: calls 1000
KATYBOSS: raises 1000 to 2000
maicon7k: calls 1000
KingTT1: calls 1000
*** TURN *** [8c 6s Th] [6d]
maicon7k: bets 4000
KingTT1: raises 854 to 4854 and is all-in
KATYBOSS: raises 990 to 5844 and is all-in
maicon7k: calls 1844
*** RIVER *** [8c 6s Th 6d] [Qd]
*** SHOW DOWN ***
maicon7k: shows [Kc 6h] (three of a kind, Sixes)
KATYBOSS: shows [8s 8h] (a full house, Eights full of Sixes)
KATYBOSS collected 1980 from side pot
KingTT1: shows [Jh Tc] (two pair, Tens and Sixes)
KATYBOSS collected 24462 from main pot
KingTT1 finished the tournament in 51st place and received 14800.
*** SUMMARY ***
Total pot 26442 Main pot 24462. Side pot 1980. | Rake 0 
Board [8c 6s Th 6d Qd]
Seat 1: mmaatthh folded before Flop (didn't bet)
Seat 2: Taargeett folded before Flop (didn't bet)
Seat 3: surf@losteri folded before Flop (didn't bet)
Seat 4: skinchamp folded before Flop (didn't bet)
Seat 5: Rhea242 folded before Flop (didn't bet)
Seat 6: Cooki2759 (button) folded before Flop (didn't bet)
Seat 7: maicon7k (small blind) showed [Kc 6h] and lost with three of a kind, Sixes
Seat 8: KingTT1 (big blind) showed [Jh Tc] and lost with two pair, Tens and Sixes
Seat 9: KATYBOSS showed [8s 8h] and won (26442) with a full house, Eights full of Sixes



PokerStars Hand #201498062864: Tournament #2629783708, 8700+1300 Hold'em No Limit - Level XIII (600/1200) - 2019/06/17 23:11:56 ET
Table '2629783708 20' 9-max Seat #7 is the button
Seat 1: mmaatthh (13383 in chips) 
Seat 2: Taargeett (21367 in chips) 
Seat 3: surf@losteri (10558 in chips) is sitting out
Seat 4: skinchamp (18806 in chips) 
Seat 5: Rhea242 (21433 in chips) 
Seat 6: Cooki2759 (5659 in chips) 
Seat 7: maicon7k (30848 in chips) 
Seat 9: KATYBOSS (26442 in chips) 
mmaatthh: posts the ante 125
Taargeett: posts the ante 125
surf@losteri: posts the ante 125
skinchamp: posts the ante 125
Rhea242: posts the ante 125
Cooki2759: posts the ante 125
maicon7k: posts the ante 125
KATYBOSS: posts the ante 125
KATYBOSS: posts small blind 600
mmaatthh: posts big blind 1200
*** HOLE CARDS ***
Dealt to Taargeett [2s Qh]
Taargeett has timed out
Taargeett: folds 
surf@losteri: folds 
skinchamp: calls 1200
Rhea242: calls 1200
Cooki2759: calls 1200
maicon7k: folds 
KATYBOSS: calls 600
mmaatthh has timed out
mmaatthh: checks 
*** FLOP *** [Qs Td Th]
KATYBOSS: bets 1200
mmaatthh has timed out
mmaatthh: folds 
skinchamp: folds 
Rhea242: folds 
Cooki2759: calls 1200
*** TURN *** [Qs Td Th] [9d]
KATYBOSS: bets 1200
Cooki2759: raises 1200 to 2400
KATYBOSS: calls 1200
*** RIVER *** [Qs Td Th 9d] [9s]
KATYBOSS: bets 1200
Cooki2759: calls 734 and is all-in
Uncalled bet (466) returned to KATYBOSS
*** SHOW DOWN ***
KATYBOSS: shows [8s As] (two pair, Tens and Nines)
Cooki2759: shows [Jc Kh] (a straight, Nine to King)
Cooki2759 collected 15668 from pot
*** SUMMARY ***
Total pot 15668 | Rake 0 
Board [Qs Td Th 9d 9s]
Seat 1: mmaatthh (big blind) folded on the Flop
Seat 2: Taargeett folded before Flop (didn't bet)
Seat 3: surf@losteri folded before Flop (didn't bet)
Seat 4: skinchamp folded on the Flop
Seat 5: Rhea242 folded on the Flop
Seat 6: Cooki2759 showed [Jc Kh] and won (15668) with a straight, Nine to King
Seat 7: maicon7k (button) folded before Flop (didn't bet)
Seat 9: KATYBOSS (small blind) showed [8s As] and lost with two pair, Tens and Nines



PokerStars Hand #201498084066: Tournament #2629783708, 8700+1300 Hold'em No Limit - Level XIII (600/1200) - 2019/06/17 23:13:39 ET
Table '2629783708 20' 9-max Seat #9 is the button
Seat 1: mmaatthh (12058 in chips) is sitting out
Seat 2: Taargeett (21242 in chips) 
Seat 3: surf@losteri (10433 in chips) is sitting out
Seat 4: skinchamp (17481 in chips) 
Seat 5: Rhea242 (20108 in chips) 
Seat 6: Cooki2759 (15668 in chips) 
Seat 7: maicon7k (30723 in chips) 
Seat 8: dantheman (21500 in chips) 
Seat 9: KATYBOSS (20783 in chips) 
mmaatthh: posts the ante 125
Taargeett: posts the ante 125
surf@losteri: posts the ante 125
skinchamp: posts the ante 125
Rhea242: posts the ante 125
Cooki2759: posts the ante 125
maicon7k: posts the ante 125
dantheman: posts the ante 125
KATYBOSS: posts the ante 125
mmaatthh: posts small blind 600
Taargeett: posts big blind 1200
*** HOLE CARDS ***
Dealt to Taargeett [Jc 7s]
surf@losteri: folds 
skinchamp: folds 
Rhea242: folds 
Cooki2759: folds 
maicon7k: raises 8400 to 9600
dantheman: calls 9600
KATYBOSS: folds 
mmaatthh: folds 
Taargeett: folds 
*** FLOP *** [4d 9d Tc]
maicon7k: bets 20998 and is all-in
dantheman: calls 11775 and is all-in
Uncalled bet (9223) returned to maicon7k
*** TURN *** [4d 9d Tc] [2s]
*** RIVER *** [4d 9d Tc 2s] [8d]
*** SHOW DOWN ***
maicon7k: shows [Qs Qc] (a pair of Queens)
dantheman: shows [Jh As] (high card Ace)
maicon7k collected 45675 from pot
dantheman finished the tournament in 43rd place and received 16600.
*** SUMMARY ***
Total pot 45675 | Rake 0 
Board [4d 9d Tc 2s 8d]
Seat 1: mmaatthh (small blind) folded before Flop
Seat 2: Taargeett (big blind) folded before Flop
Seat 3: surf@losteri folded before Flop (didn't bet)
Seat 4: skinchamp folded before Flop (didn't bet)
Seat 5: Rhea242 folded before Flop (didn't bet)
Seat 6: Cooki2759 folded before Flop (didn't bet)
Seat 7: maicon7k showed [Qs Qc] and won (45675) with a pair of Queens
Seat 8: dantheman showed [Jh As] and lost with high card Ace
Seat 9: KATYBOSS (button) folded before Flop (didn't bet)



PokerStars Hand #201498091249: Tournament #2629783708, 8700+1300 Hold'em No Limit - Level XIII (600/1200) - 2019/06/17 23:14:15 ET
Table '2629783708 20' 9-max Seat #1 is the button
Seat 1: mmaatthh (11333 in chips) is sitting out
Seat 2: Taargeett (19917 in chips) 
Seat 3: surf@losteri (10308 in chips) is sitting out
Seat 4: skinchamp (17356 in chips) 
Seat 5: Rhea242 (19983 in chips) 
Seat 6: Cooki2759 (15543 in chips) 
Seat 7: maicon7k (54898 in chips) 
Seat 9: KATYBOSS (20658 in chips) 
mmaatthh: posts the ante 125
Taargeett: posts the ante 125
surf@losteri: posts the ante 125
skinchamp: posts the ante 125
Rhea242: posts the ante 125
Cooki2759: posts the ante 125
maicon7k: posts the ante 125
KATYBOSS: posts the ante 125
Taargeett: posts small blind 600
surf@losteri: posts big blind 1200
*** HOLE CARDS ***
Dealt to Taargeett [2s 4d]
skinchamp: folds 
Rhea242: folds 
Cooki2759: raises 1200 to 2400
maicon7k: folds 
KATYBOSS: folds 
mmaatthh: folds 
Taargeett: folds 
surf@losteri: folds 
Uncalled bet (1200) returned to Cooki2759
Cooki2759 collected 4000 from pot
Cooki2759: doesn't show hand 
*** SUMMARY ***
Total pot 4000 | Rake 0 
Seat 1: mmaatthh (button) folded before Flop (didn't bet)
Seat 2: Taargeett (small blind) folded before Flop
Seat 3: surf@losteri (big blind) folded before Flop
Seat 4: skinchamp folded before Flop (didn't bet)
Seat 5: Rhea242 folded before Flop (didn't bet)
Seat 6: Cooki2759 collected (4000)
Seat 7: maicon7k folded before Flop (didn't bet)
Seat 9: KATYBOSS folded before Flop (didn't bet)



PokerStars Hand #201498095416: Tournament #2629783708, 8700+1300 Hold'em No Limit - Level XIII (600/1200) - 2019/06/17 23:14:35 ET
Table '2629783708 20' 9-max Seat #2 is the button
Seat 1: mmaatthh (11208 in chips) is sitting out
Seat 2: Taargeett (19192 in chips) 
Seat 3: surf@losteri (8983 in chips) is sitting out
Seat 4: skinchamp (17231 in chips) 
Seat 5: Rhea242 (19858 in chips) 
Seat 6: Cooki2759 (18218 in chips) 
Seat 7: maicon7k (54773 in chips) 
Seat 9: KATYBOSS (20533 in chips) 
mmaatthh: posts the ante 125
Taargeett: posts the ante 125
surf@losteri: posts the ante 125
skinchamp: posts the ante 125
Rhea242: posts the ante 125
Cooki2759: posts the ante 125
maicon7k: posts the ante 125
KATYBOSS: posts the ante 125
surf@losteri: posts small blind 600
skinchamp: posts big blind 1200
*** HOLE CARDS ***
Dealt to Taargeett [Qd 2h]
Rhea242: folds 
Cooki2759: folds 
maicon7k: folds 
KATYBOSS: folds 
mmaatthh: folds 
Taargeett: folds 
surf@losteri: folds 
Uncalled bet (600) returned to skinchamp
skinchamp collected 2200 from pot
*** SUMMARY ***
Total pot 2200 | Rake 0 
Seat 1: mmaatthh folded before Flop (didn't bet)
Seat 2: Taargeett (button) folded before Flop (didn't bet)
Seat 3: surf@losteri (small blind) folded before Flop
Seat 4: skinchamp (big blind) collected (2200)
Seat 5: Rhea242 folded before Flop (didn't bet)
Seat 6: Cooki2759 folded before Flop (didn't bet)
Seat 7: maicon7k folded before Flop (didn't bet)
Seat 9: KATYBOSS folded before Flop (didn't bet)



PokerStars Hand #201498100471: Tournament #2629783708, 8700+1300 Hold'em No Limit - Level XIII (600/1200) - 2019/06/17 23:15:00 ET
Table '2629783708 20' 9-max Seat #3 is the button
Seat 1: mmaatthh (11083 in chips) is sitting out
Seat 2: Taargeett (19067 in chips) 
Seat 3: surf@losteri (8258 in chips) is sitting out
Seat 4: skinchamp (18706 in chips) 
Seat 5: Rhea242 (19733 in chips) 
Seat 6: Cooki2759 (18093 in chips) 
Seat 7: maicon7k (54648 in chips) 
Seat 9: KATYBOSS (20408 in chips) 
mmaatthh: posts the ante 125
Taargeett: posts the ante 125
surf@losteri: posts the ante 125
skinchamp: posts the ante 125
Rhea242: posts the ante 125
Cooki2759: posts the ante 125
maicon7k: posts the ante 125
KATYBOSS: posts the ante 125
skinchamp: posts small blind 600
Rhea242: posts big blind 1200
*** HOLE CARDS ***
Dealt to Taargeett [Ts 4h]
Cooki2759: folds 
maicon7k: folds 
KATYBOSS: calls 1200
mmaatthh: folds 
Taargeett: folds 
surf@losteri: folds 
skinchamp: calls 600
Rhea242: checks 
*** FLOP *** [3s 7s Qc]
skinchamp: checks 
Rhea242: bets 1200
KATYBOSS: raises 17883 to 19083 and is all-in
skinchamp: folds 
Rhea242: folds 
Uncalled bet (17883) returned to KATYBOSS
KATYBOSS collected 7000 from pot
*** SUMMARY ***
Total pot 7000 | Rake 0 
Board [3s 7s Qc]
Seat 1: mmaatthh folded before Flop (didn't bet)
Seat 2: Taargeett folded before Flop (didn't bet)
Seat 3: surf@losteri (button) folded before Flop (didn't bet)
Seat 4: skinchamp (small blind) folded on the Flop
Seat 5: Rhea242 (big blind) folded on the Flop
Seat 6: Cooki2759 folded before Flop (didn't bet)
Seat 7: maicon7k folded before Flop (didn't bet)
Seat 9: KATYBOSS collected (7000)



PokerStars Hand #201498107778: Tournament #2629783708, 8700+1300 Hold'em No Limit - Level XIII (600/1200) - 2019/06/17 23:15:36 ET
Table '2629783708 20' 9-max Seat #4 is the button
Seat 1: mmaatthh (10958 in chips) is sitting out
Seat 2: Taargeett (18942 in chips) 
Seat 3: surf@losteri (8133 in chips) is sitting out
Seat 4: skinchamp (17381 in chips) 
Seat 5: Rhea242 (17208 in chips) 
Seat 6: Cooki2759 (17968 in chips) 
Seat 7: maicon7k (54523 in chips) 
Seat 9: KATYBOSS (24883 in chips) 
mmaatthh: posts the ante 125
Taargeett: posts the ante 125
surf@losteri: posts the ante 125
skinchamp: posts the ante 125
Rhea242: posts the ante 125
Cooki2759: posts the ante 125
maicon7k: posts the ante 125
KATYBOSS: posts the ante 125
Rhea242: posts small blind 600
Cooki2759: posts big blind 1200
*** HOLE CARDS ***
Dealt to Taargeett [7s 3d]
maicon7k: folds 
KATYBOSS: folds 
mmaatthh: folds 
Taargeett: folds 
surf@losteri: folds 
skinchamp: folds 
Rhea242: calls 600
Cooki2759: checks 
*** FLOP *** [9h 6s Ad]
Rhea242: checks 
Cooki2759: bets 1200
Rhea242: calls 1200
*** TURN *** [9h 6s Ad] [8s]
Rhea242: checks 
Cooki2759: bets 5800
Rhea242: folds 
Uncalled bet (5800) returned to Cooki2759
Cooki2759 collected 5800 from pot
Cooki2759: doesn't show hand 
*** SUMMARY ***
Total pot 5800 | Rake 0 
Board [9h 6s Ad 8s]
Seat 1: mmaatthh folded before Flop (didn't bet)
Seat 2: Taargeett folded before Flop (didn't bet)
Seat 3: surf@losteri folded before Flop (didn't bet)
Seat 4: skinchamp (button) folded before Flop (didn't bet)
Seat 5: Rhea242 (small blind) folded on the Turn
Seat 6: Cooki2759 (big blind) collected (5800)
Seat 7: maicon7k folded before Flop (didn't bet)
Seat 9: KATYBOSS folded before Flop (didn't bet)



PokerStars Hand #201498119373: Tournament #2629783708, 8700+1300 Hold'em No Limit - Level XIV (800/1600) - 2019/06/17 23:16:33 ET
Table '2629783708 20' 9-max Seat #5 is the button
Seat 1: mmaatthh (10833 in chips) is sitting out
Seat 2: Taargeett (18817 in chips) 
Seat 3: surf@losteri (8008 in chips) is sitting out
Seat 4: skinchamp (17256 in chips) 
Seat 5: Rhea242 (14683 in chips) 
Seat 6: Cooki2759 (21243 in chips) 
Seat 7: maicon7k (54398 in chips) 
Seat 9: KATYBOSS (24758 in chips) 
mmaatthh: posts the ante 150
Taargeett: posts the ante 150
surf@losteri: posts the ante 150
skinchamp: posts the ante 150
Rhea242: posts the ante 150
Cooki2759: posts the ante 150
maicon7k: posts the ante 150
KATYBOSS: posts the ante 150
Cooki2759: posts small blind 800
maicon7k: posts big blind 1600
*** HOLE CARDS ***
Dealt to Taargeett [8d 8s]
KATYBOSS: folds 
mmaatthh: folds 
Taargeett: raises 5200 to 6800
surf@losteri: folds 
skinchamp: folds 
Rhea242: folds 
Cooki2759: folds 
maicon7k: folds 
Uncalled bet (5200) returned to Taargeett
Taargeett collected 5200 from pot
Taargeett: doesn't show hand 
*** SUMMARY ***
Total pot 5200 | Rake 0 
Seat 1: mmaatthh folded before Flop (didn't bet)
Seat 2: Taargeett collected (5200)
Seat 3: surf@losteri folded before Flop (didn't bet)
Seat 4: skinchamp folded before Flop (didn't bet)
Seat 5: Rhea242 (button) folded before Flop (didn't bet)
Seat 6: Cooki2759 (small blind) folded before Flop
Seat 7: maicon7k (big blind) folded before Flop
Seat 9: KATYBOSS folded before Flop (didn't bet)



PokerStars Hand #201498124742: Tournament #2629783708, 8700+1300 Hold'em No Limit - Level XIV (800/1600) - 2019/06/17 23:17:00 ET
Table '2629783708 20' 9-max Seat #6 is the button
Seat 1: mmaatthh (10683 in chips) is sitting out
Seat 2: Taargeett (22267 in chips) 
Seat 3: surf@losteri (7858 in chips) is sitting out
Seat 4: skinchamp (17106 in chips) 
Seat 5: Rhea242 (14533 in chips) 
Seat 6: Cooki2759 (20293 in chips) 
Seat 7: maicon7k (52648 in chips) 
Seat 9: KATYBOSS (24608 in chips) 
mmaatthh: posts the ante 150
Taargeett: posts the ante 150
surf@losteri: posts the ante 150
skinchamp: posts the ante 150
Rhea242: posts the ante 150
Cooki2759: posts the ante 150
maicon7k: posts the ante 150
KATYBOSS: posts the ante 150
maicon7k: posts small blind 800
KATYBOSS: posts big blind 1600
*** HOLE CARDS ***
Dealt to Taargeett [7h Td]
mmaatthh: folds 
Taargeett: folds 
surf@losteri: folds 
skinchamp: folds 
Rhea242: folds 
Cooki2759: folds 
maicon7k: raises 1600 to 3200
KATYBOSS: raises 21258 to 24458 and is all-in
maicon7k has timed out
maicon7k: folds 
Uncalled bet (21258) returned to KATYBOSS
KATYBOSS collected 7600 from pot
*** SUMMARY ***
Total pot 7600 | Rake 0 
Seat 1: mmaatthh folded before Flop (didn't bet)
Seat 2: Taargeett folded before Flop (didn't bet)
Seat 3: surf@losteri folded before Flop (didn't bet)
Seat 4: skinchamp folded before Flop (didn't bet)
Seat 5: Rhea242 folded before Flop (didn't bet)
Seat 6: Cooki2759 (button) folded before Flop (didn't bet)
Seat 7: maicon7k (small blind) folded before Flop
Seat 9: KATYBOSS (big blind) collected (7600)



PokerStars Hand #201498134317: Tournament #2629783708, 8700+1300 Hold'em No Limit - Level XIV (800/1600) - 2019/06/17 23:17:47 ET
Table '2629783708 20' 9-max Seat #7 is the button
Seat 1: mmaatthh (10533 in chips) is sitting out
Seat 2: Taargeett (22117 in chips) 
Seat 3: surf@losteri (7708 in chips) 
Seat 4: skinchamp (16956 in chips) 
Seat 5: Rhea242 (14383 in chips) 
Seat 6: Cooki2759 (20143 in chips) 
Seat 7: maicon7k (49298 in chips) 
Seat 8: ulises23101959 (50110 in chips) out of hand (moved from another table into small blind)
Seat 9: KATYBOSS (28858 in chips) 
ulises23101959 will be allowed to play after the button
mmaatthh: posts the ante 150
Taargeett: posts the ante 150
surf@losteri: posts the ante 150
skinchamp: posts the ante 150
Rhea242: posts the ante 150
Cooki2759: posts the ante 150
maicon7k: posts the ante 150
KATYBOSS: posts the ante 150
KATYBOSS: posts small blind 800
mmaatthh: posts big blind 1600
*** HOLE CARDS ***
Dealt to Taargeett [2s 9c]
Taargeett: folds 
surf@losteri: folds 
skinchamp: folds 
Rhea242: folds 
Cooki2759: folds 
maicon7k: folds 
KATYBOSS: raises 1600 to 3200
mmaatthh: folds 
Uncalled bet (1600) returned to KATYBOSS
KATYBOSS collected 4400 from pot
*** SUMMARY ***
Total pot 4400 | Rake 0 
Seat 1: mmaatthh (big blind) folded before Flop
Seat 2: Taargeett folded before Flop (didn't bet)
Seat 3: surf@losteri folded before Flop (didn't bet)
Seat 4: skinchamp folded before Flop (didn't bet)
Seat 5: Rhea242 folded before Flop (didn't bet)
Seat 6: Cooki2759 folded before Flop (didn't bet)
Seat 7: maicon7k (button) folded before Flop (didn't bet)
Seat 9: KATYBOSS (small blind) collected (4400)



PokerStars Hand #201498143096: Tournament #2629783708, 8700+1300 Hold'em No Limit - Level XIV (800/1600) - 2019/06/17 23:18:30 ET
Table '2629783708 20' 9-max Seat #9 is the button
Seat 1: mmaatthh (8783 in chips) is sitting out
Seat 2: Taargeett (21967 in chips) 
Seat 3: surf@losteri (7558 in chips) 
Seat 4: skinchamp (16806 in chips) 
Seat 5: Rhea242 (14233 in chips) 
Seat 6: Cooki2759 (19993 in chips) 
Seat 7: maicon7k (49148 in chips) 
Seat 8: ulises23101959 (50110 in chips) 
Seat 9: KATYBOSS (31508 in chips) 
mmaatthh: posts the ante 150
Taargeett: posts the ante 150
surf@losteri: posts the ante 150
skinchamp: posts the ante 150
Rhea242: posts the ante 150
Cooki2759: posts the ante 150
maicon7k: posts the ante 150
ulises23101959: posts the ante 150
KATYBOSS: posts the ante 150
mmaatthh: posts small blind 800
Taargeett: posts big blind 1600
*** HOLE CARDS ***
Dealt to Taargeett [Qs 7h]
surf@losteri: folds 
skinchamp: raises 3200 to 4800
Rhea242: folds 
Cooki2759: calls 4800
maicon7k: folds 
ulises23101959: folds 
KATYBOSS: folds 
mmaatthh: folds 
Taargeett: folds 
*** FLOP *** [Ks 3s Kc]
skinchamp: checks 
Cooki2759: bets 1600
skinchamp: raises 1600 to 3200
Cooki2759: calls 1600
*** TURN *** [Ks 3s Kc] [7d]
skinchamp: bets 1600
Cooki2759: calls 1600
*** RIVER *** [Ks 3s Kc 7d] [8c]
skinchamp: bets 7056 and is all-in
Cooki2759: folds 
Uncalled bet (7056) returned to skinchamp
skinchamp collected 22950 from pot
*** SUMMARY ***
Total pot 22950 | Rake 0 
Board [Ks 3s Kc 7d 8c]
Seat 1: mmaatthh (small blind) folded before Flop
Seat 2: Taargeett (big blind) folded before Flop
Seat 3: surf@losteri folded before Flop (didn't bet)
Seat 4: skinchamp collected (22950)
Seat 5: Rhea242 folded before Flop (didn't bet)
Seat 6: Cooki2759 folded on the River
Seat 7: maicon7k folded before Flop (didn't bet)
Seat 8: ulises23101959 folded before Flop (didn't bet)
Seat 9: KATYBOSS (button) folded before Flop (didn't bet)



PokerStars Hand #201498154115: Tournament #2629783708, 8700+1300 Hold'em No Limit - Level XIV (800/1600) - 2019/06/17 23:19:25 ET
Table '2629783708 20' 9-max Seat #1 is the button
Seat 1: mmaatthh (7833 in chips) is sitting out
Seat 2: Taargeett (20217 in chips) 
Seat 3: surf@losteri (7408 in chips) 
Seat 4: skinchamp (30006 in chips) 
Seat 5: Rhea242 (14083 in chips) 
Seat 6: Cooki2759 (10243 in chips) 
Seat 7: maicon7k (48998 in chips) 
Seat 8: ulises23101959 (49960 in chips) 
Seat 9: KATYBOSS (31358 in chips) 
mmaatthh: posts the ante 150
Taargeett: posts the ante 150
surf@losteri: posts the ante 150
skinchamp: posts the ante 150
Rhea242: posts the ante 150
Cooki2759: posts the ante 150
maicon7k: posts the ante 150
ulises23101959: posts the ante 150
KATYBOSS: posts the ante 150
Taargeett: posts small blind 800
surf@losteri: posts big blind 1600
*** HOLE CARDS ***
Dealt to Taargeett [Kc 6c]
skinchamp: calls 1600
Rhea242: folds 
Cooki2759: folds 
maicon7k: folds 
ulises23101959: folds 
KATYBOSS: calls 1600
mmaatthh: folds 
Taargeett: raises 1600 to 3200
surf@losteri: calls 1600
skinchamp: calls 1600
KATYBOSS: calls 1600
*** FLOP *** [3c 8d 2c]
Taargeett: bets 16867 and is all-in
surf@losteri: calls 4058 and is all-in
skinchamp: folds 
KATYBOSS: folds 
Uncalled bet (12809) returned to Taargeett
*** TURN *** [3c 8d 2c] [As]
*** RIVER *** [3c 8d 2c As] [5d]
*** SHOW DOWN ***
Taargeett: shows [Kc 6c] (high card Ace)
surf@losteri: shows [7c Jc] (high card Ace - lower kicker)
Taargeett collected 22266 from pot
surf@losteri finished the tournament in 36th place and received 18800.
*** SUMMARY ***
Total pot 22266 | Rake 0 
Board [3c 8d 2c As 5d]
Seat 1: mmaatthh (button) folded before Flop (didn't bet)
Seat 2: Taargeett (small blind) showed [Kc 6c] and won (22266) with high card Ace
Seat 3: surf@losteri (big blind) showed [7c Jc] and lost with high card Ace
Seat 4: skinchamp folded on the Flop
Seat 5: Rhea242 folded before Flop (didn't bet)
Seat 6: Cooki2759 folded before Flop (didn't bet)
Seat 7: maicon7k folded before Flop (didn't bet)
Seat 8: ulises23101959 folded before Flop (didn't bet)
Seat 9: KATYBOSS folded on the Flop



PokerStars Hand #201498163823: Tournament #2629783708, 8700+1300 Hold'em No Limit - Level XIV (800/1600) - 2019/06/17 23:20:13 ET
Table '2629783708 20' 9-max Seat #2 is the button
Seat 1: mmaatthh (7683 in chips) is sitting out
Seat 2: Taargeett (35075 in chips) 
Seat 4: skinchamp (26656 in chips) 
Seat 5: Rhea242 (13933 in chips) 
Seat 6: Cooki2759 (10093 in chips) 
Seat 7: maicon7k (48848 in chips) 
Seat 8: ulises23101959 (49810 in chips) 
Seat 9: KATYBOSS (28008 in chips) 
mmaatthh: posts the ante 150
Taargeett: posts the ante 150
skinchamp: posts the ante 150
Rhea242: posts the ante 150
Cooki2759: posts the ante 150
maicon7k: posts the ante 150
ulises23101959: posts the ante 150
KATYBOSS: posts the ante 150
skinchamp: posts small blind 800
Rhea242: posts big blind 1600
*** HOLE CARDS ***
Dealt to Taargeett [4h 7c]
Cooki2759: folds 
maicon7k: calls 1600
ulises23101959: folds 
KATYBOSS: raises 1600 to 3200
mmaatthh: folds 
Taargeett: folds 
skinchamp: folds 
Rhea242: folds 
maicon7k has timed out
maicon7k: folds 
Uncalled bet (1600) returned to KATYBOSS
KATYBOSS collected 6800 from pot
*** SUMMARY ***
Total pot 6800 | Rake 0 
Seat 1: mmaatthh folded before Flop (didn't bet)
Seat 2: Taargeett (button) folded before Flop (didn't bet)
Seat 4: skinchamp (small blind) folded before Flop
Seat 5: Rhea242 (big blind) folded before Flop
Seat 6: Cooki2759 folded before Flop (didn't bet)
Seat 7: maicon7k folded before Flop
Seat 8: ulises23101959 folded before Flop (didn't bet)
Seat 9: KATYBOSS collected (6800)



PokerStars Hand #201498176936: Tournament #2629783708, 8700+1300 Hold'em No Limit - Level XV (1000/2000) - 2019/06/17 23:21:19 ET
Table '2629783708 20' 9-max Seat #4 is the button
Seat 1: mmaatthh (7533 in chips) is sitting out
Seat 2: Taargeett (34925 in chips) 
Seat 4: skinchamp (25706 in chips) 
Seat 5: Rhea242 (12183 in chips) 
Seat 6: Cooki2759 (9943 in chips) 
Seat 7: maicon7k (47098 in chips) is sitting out
Seat 8: ulises23101959 (49660 in chips) 
Seat 9: KATYBOSS (33058 in chips) 
mmaatthh: posts the ante 200
Taargeett: posts the ante 200
skinchamp: posts the ante 200
Rhea242: posts the ante 200
Cooki2759: posts the ante 200
maicon7k: posts the ante 200
ulises23101959: posts the ante 200
KATYBOSS: posts the ante 200
Rhea242: posts small blind 1000
Cooki2759: posts big blind 2000
*** HOLE CARDS ***
Dealt to Taargeett [3h Tc]
maicon7k: folds 
ulises23101959: calls 2000
KATYBOSS: folds 
mmaatthh: folds 
Taargeett: folds 
skinchamp: raises 8600 to 10600
Rhea242: folds 
Cooki2759: folds 
ulises23101959: folds 
Uncalled bet (8600) returned to skinchamp
skinchamp collected 8600 from pot
*** SUMMARY ***
Total pot 8600 | Rake 0 
Seat 1: mmaatthh folded before Flop (didn't bet)
Seat 2: Taargeett folded before Flop (didn't bet)
Seat 4: skinchamp (button) collected (8600)
Seat 5: Rhea242 (small blind) folded before Flop
Seat 6: Cooki2759 (big blind) folded before Flop
Seat 7: maicon7k folded before Flop (didn't bet)
Seat 8: ulises23101959 folded before Flop
Seat 9: KATYBOSS folded before Flop (didn't bet)



PokerStars Hand #201498183659: Tournament #2629783708, 8700+1300 Hold'em No Limit - Level XV (1000/2000) - 2019/06/17 23:21:52 ET
Table '2629783708 20' 9-max Seat #5 is the button
Seat 1: mmaatthh (7333 in chips) is sitting out
Seat 2: Taargeett (34725 in chips) 
Seat 4: skinchamp (32106 in chips) 
Seat 5: Rhea242 (10983 in chips) 
Seat 6: Cooki2759 (7743 in chips) 
Seat 7: maicon7k (46898 in chips) is sitting out
Seat 8: ulises23101959 (47460 in chips) 
Seat 9: KATYBOSS (32858 in chips) 
mmaatthh: posts the ante 200
Taargeett: posts the ante 200
skinchamp: posts the ante 200
Rhea242: posts the ante 200
Cooki2759: posts the ante 200
maicon7k: posts the ante 200
ulises23101959: posts the ante 200
KATYBOSS: posts the ante 200
Cooki2759: posts small blind 1000
maicon7k: posts big blind 2000
*** HOLE CARDS ***
Dealt to Taargeett [4c 4d]
ulises23101959: folds 
KATYBOSS: folds 
mmaatthh: folds 
Taargeett: raises 6600 to 8600
skinchamp: folds 
Rhea242: folds 
Cooki2759: folds 
maicon7k: folds 
Uncalled bet (6600) returned to Taargeett
Taargeett collected 6600 from pot
Taargeett: doesn't show hand 
*** SUMMARY ***
Total pot 6600 | Rake 0 
Seat 1: mmaatthh folded before Flop (didn't bet)
Seat 2: Taargeett collected (6600)
Seat 4: skinchamp folded before Flop (didn't bet)
Seat 5: Rhea242 (button) folded before Flop (didn't bet)
Seat 6: Cooki2759 (small blind) folded before Flop
Seat 7: maicon7k (big blind) folded before Flop
Seat 8: ulises23101959 folded before Flop (didn't bet)
Seat 9: KATYBOSS folded before Flop (didn't bet)



PokerStars Hand #201498187763: Tournament #2629783708, 8700+1300 Hold'em No Limit - Level XV (1000/2000) - 2019/06/17 23:22:13 ET
Table '2629783708 20' 9-max Seat #6 is the button
Seat 1: mmaatthh (7133 in chips) is sitting out
Seat 2: Taargeett (39125 in chips) 
Seat 4: skinchamp (31906 in chips) 
Seat 5: Rhea242 (10783 in chips) 
Seat 6: Cooki2759 (6543 in chips) 
Seat 7: maicon7k (44698 in chips) 
Seat 8: ulises23101959 (47260 in chips) 
Seat 9: KATYBOSS (32658 in chips) 
mmaatthh: posts the ante 200
Taargeett: posts the ante 200
skinchamp: posts the ante 200
Rhea242: posts the ante 200
Cooki2759: posts the ante 200
maicon7k: posts the ante 200
ulises23101959: posts the ante 200
KATYBOSS: posts the ante 200
maicon7k: posts small blind 1000
ulises23101959: posts big blind 2000
*** HOLE CARDS ***
Dealt to Taargeett [6c 5c]
KATYBOSS: folds 
mmaatthh: folds 
Taargeett: folds 
skinchamp: folds 
Rhea242: raises 8583 to 10583 and is all-in
Cooki2759: folds 
maicon7k: calls 9583
ulises23101959: calls 8583
*** FLOP *** [Kc 3d 8d]
maicon7k: bets 4000
ulises23101959: calls 4000
*** TURN *** [Kc 3d 8d] [Td]
maicon7k: bets 4000
ulises23101959: calls 4000
*** RIVER *** [Kc 3d 8d Td] [Jh]
maicon7k: bets 8000
ulises23101959: calls 8000
*** SHOW DOWN ***
maicon7k: shows [5d Ad] (a flush, Ace high)
ulises23101959: mucks hand 
maicon7k collected 32000 from side pot
Rhea242: mucks hand 
maicon7k collected 33349 from main pot
Rhea242 finished the tournament in 33rd place and received 18800.
*** SUMMARY ***
Total pot 65349 Main pot 33349. Side pot 32000. | Rake 0 
Board [Kc 3d 8d Td Jh]
Seat 1: mmaatthh folded before Flop (didn't bet)
Seat 2: Taargeett folded before Flop (didn't bet)
Seat 4: skinchamp folded before Flop (didn't bet)
Seat 5: Rhea242 mucked [Ah 4h]
Seat 6: Cooki2759 (button) folded before Flop (didn't bet)
Seat 7: maicon7k (small blind) showed [5d Ad] and won (65349) with a flush, Ace high
Seat 8: ulises23101959 (big blind) mucked [Kh Jd]
Seat 9: KATYBOSS folded before Flop (didn't bet)



PokerStars Hand #201498197185: Tournament #2629783708, 8700+1300 Hold'em No Limit - Level XV (1000/2000) - 2019/06/17 23:22:59 ET
Table '2629783708 20' 9-max Seat #7 is the button
Seat 1: mmaatthh (6933 in chips) is sitting out
Seat 2: Taargeett (38925 in chips) 
Seat 4: skinchamp (31706 in chips) 
Seat 6: Cooki2759 (6343 in chips) 
Seat 7: maicon7k (83264 in chips) 
Seat 8: ulises23101959 (20477 in chips) 
Seat 9: KATYBOSS (32458 in chips) 
mmaatthh: posts the ante 200
Taargeett: posts the ante 200
skinchamp: posts the ante 200
Cooki2759: posts the ante 200
maicon7k: posts the ante 200
ulises23101959: posts the ante 200
KATYBOSS: posts the ante 200
ulises23101959: posts small blind 1000
KATYBOSS: posts big blind 2000
*** HOLE CARDS ***
Dealt to Taargeett [Js 4d]
mmaatthh: folds 
Taargeett: folds 
skinchamp: folds 
Cooki2759: folds 
maicon7k: calls 2000
ulises23101959: calls 1000
KATYBOSS: checks 
*** FLOP *** [2s 4h 7d]
ulises23101959: bets 2000
KATYBOSS: folds 
maicon7k: calls 2000
*** TURN *** [2s 4h 7d] [8d]
ulises23101959: bets 2000
maicon7k: calls 2000
*** RIVER *** [2s 4h 7d 8d] [3c]
ulises23101959: bets 6000
maicon7k: folds 
Uncalled bet (6000) returned to ulises23101959
ulises23101959 collected 15400 from pot
ulises23101959: doesn't show hand 
*** SUMMARY ***
Total pot 15400 | Rake 0 
Board [2s 4h 7d 8d 3c]
Seat 1: mmaatthh folded before Flop (didn't bet)
Seat 2: Taargeett folded before Flop (didn't bet)
Seat 4: skinchamp folded before Flop (didn't bet)
Seat 6: Cooki2759 folded before Flop (didn't bet)
Seat 7: maicon7k (button) folded on the River
Seat 8: ulises23101959 (small blind) collected (15400)
Seat 9: KATYBOSS (big blind) folded on the Flop



PokerStars Hand #201498207560: Tournament #2629783708, 8700+1300 Hold'em No Limit - Level XV (1000/2000) - 2019/06/17 23:23:52 ET
Table '2629783708 20' 9-max Seat #8 is the button
Seat 1: mmaatthh (6733 in chips) is sitting out
Seat 2: Taargeett (38725 in chips) 
Seat 4: skinchamp (31506 in chips) 
Seat 5: amazing001 (1607 in chips) 
Seat 6: Cooki2759 (6143 in chips) 
Seat 7: maicon7k (77064 in chips) 
Seat 8: ulises23101959 (29677 in chips) 
Seat 9: KATYBOSS (30258 in chips) 
mmaatthh: posts the ante 200
Taargeett: posts the ante 200
skinchamp: posts the ante 200
amazing001: posts the ante 200
Cooki2759: posts the ante 200
maicon7k: posts the ante 200
ulises23101959: posts the ante 200
KATYBOSS: posts the ante 200
KATYBOSS: posts small blind 1000
mmaatthh: posts big blind 2000
*** HOLE CARDS ***
Dealt to Taargeett [9s Td]
Taargeett: folds 
skinchamp: folds 
amazing001 has timed out
amazing001: folds 
Cooki2759: folds 
maicon7k: raises 2000 to 4000
ulises23101959: folds 
KATYBOSS has timed out
KATYBOSS: folds 
mmaatthh: folds 
Uncalled bet (2000) returned to maicon7k
maicon7k collected 6600 from pot
maicon7k: doesn't show hand 
*** SUMMARY ***
Total pot 6600 | Rake 0 
Seat 1: mmaatthh (big blind) folded before Flop
Seat 2: Taargeett folded before Flop (didn't bet)
Seat 4: skinchamp folded before Flop (didn't bet)
Seat 5: amazing001 folded before Flop (didn't bet)
Seat 6: Cooki2759 folded before Flop (didn't bet)
Seat 7: maicon7k collected (6600)
Seat 8: ulises23101959 (button) folded before Flop (didn't bet)
Seat 9: KATYBOSS (small blind) folded before Flop



PokerStars Hand #201498218963: Tournament #2629783708, 8700+1300 Hold'em No Limit - Level XV (1000/2000) - 2019/06/17 23:24:50 ET
Table '2629783708 20' 9-max Seat #9 is the button
Seat 1: mmaatthh (4533 in chips) is sitting out
Seat 2: Taargeett (38525 in chips) 
Seat 4: skinchamp (31306 in chips) 
Seat 5: amazing001 (1407 in chips) 
Seat 6: Cooki2759 (5943 in chips) 
Seat 7: maicon7k (81464 in chips) 
Seat 8: ulises23101959 (29477 in chips) 
Seat 9: KATYBOSS (29058 in chips) is sitting out
mmaatthh: posts the ante 200
Taargeett: posts the ante 200
skinchamp: posts the ante 200
amazing001: posts the ante 200
Cooki2759: posts the ante 200
maicon7k: posts the ante 200
ulises23101959: posts the ante 200
KATYBOSS: posts the ante 200
mmaatthh: posts small blind 1000
Taargeett: posts big blind 2000
*** HOLE CARDS ***
Dealt to Taargeett [4h 2h]
skinchamp: calls 2000
amazing001 has timed out
amazing001: folds 
Cooki2759: folds 
maicon7k: folds 
ulises23101959: folds 
KATYBOSS: folds 
mmaatthh: folds 
Taargeett: checks 
*** FLOP *** [Jc Ks Qc]
Taargeett: checks 
skinchamp: bets 3300
Taargeett: folds 
Uncalled bet (3300) returned to skinchamp
skinchamp collected 6600 from pot
*** SUMMARY ***
Total pot 6600 | Rake 0 
Board [Jc Ks Qc]
Seat 1: mmaatthh (small blind) folded before Flop
Seat 2: Taargeett (big blind) folded on the Flop
Seat 4: skinchamp collected (6600)
Seat 5: amazing001 folded before Flop (didn't bet)
Seat 6: Cooki2759 folded before Flop (didn't bet)
Seat 7: maicon7k folded before Flop (didn't bet)
Seat 8: ulises23101959 folded before Flop (didn't bet)
Seat 9: KATYBOSS (button) folded before Flop (didn't bet)



PokerStars Hand #201498226533: Tournament #2629783708, 8700+1300 Hold'em No Limit - Level XV (1000/2000) - 2019/06/17 23:25:28 ET
Table '2629783708 20' 9-max Seat #1 is the button
Seat 1: mmaatthh (3333 in chips) is sitting out
Seat 2: Taargeett (36325 in chips) 
Seat 4: skinchamp (35706 in chips) 
Seat 6: Cooki2759 (5743 in chips) 
Seat 7: maicon7k (81264 in chips) 
Seat 8: ulises23101959 (29277 in chips) 
Seat 9: KATYBOSS (28858 in chips) is sitting out
mmaatthh: posts the ante 200
Taargeett: posts the ante 200
skinchamp: posts the ante 200
Cooki2759: posts the ante 200
maicon7k: posts the ante 200
ulises23101959: posts the ante 200
KATYBOSS: posts the ante 200
Taargeett: posts small blind 1000
skinchamp: posts big blind 2000
*** HOLE CARDS ***
Dealt to Taargeett [8c 6h]
Cooki2759: folds 
maicon7k: folds 
ulises23101959 has timed out
ulises23101959: folds 
KATYBOSS: folds 
mmaatthh: folds 
Taargeett: folds 
Uncalled bet (1000) returned to skinchamp
skinchamp collected 3400 from pot
*** SUMMARY ***
Total pot 3400 | Rake 0 
Seat 1: mmaatthh (button) folded before Flop (didn't bet)
Seat 2: Taargeett (small blind) folded before Flop
Seat 4: skinchamp (big blind) collected (3400)
Seat 6: Cooki2759 folded before Flop (didn't bet)
Seat 7: maicon7k folded before Flop (didn't bet)
Seat 8: ulises23101959 folded before Flop (didn't bet)
Seat 9: KATYBOSS folded before Flop (didn't bet)



PokerStars Hand #201498232660: Tournament #2629783708, 8700+1300 Hold'em No Limit - Level XV (1000/2000) - 2019/06/17 23:25:58 ET
Table '2629783708 20' 9-max Seat #2 is the button
Seat 1: mmaatthh (3133 in chips) is sitting out
Seat 2: Taargeett (35125 in chips) 
Seat 3: amazing001 (1207 in chips) out of hand (moved from another table into small blind)
Seat 4: skinchamp (37906 in chips) 
Seat 5: JEC rules (5205 in chips) 
Seat 6: Cooki2759 (5543 in chips) 
Seat 7: maicon7k (81064 in chips) 
Seat 8: ulises23101959 (29077 in chips) is sitting out
Seat 9: KATYBOSS (28658 in chips) is sitting out
amazing001 will be allowed to play after the button
mmaatthh: posts the ante 200
Taargeett: posts the ante 200
skinchamp: posts the ante 200
JEC rules: posts the ante 200
Cooki2759: posts the ante 200
maicon7k: posts the ante 200
ulises23101959: posts the ante 200
KATYBOSS: posts the ante 200
skinchamp: posts small blind 1000
JEC rules: posts big blind 2000
*** HOLE CARDS ***
Dealt to Taargeett [Jd 6c]
Cooki2759: folds 
maicon7k: folds 
ulises23101959: folds 
KATYBOSS: folds 
mmaatthh: folds 
Taargeett: folds 
skinchamp: calls 1000
JEC rules: checks 
*** FLOP *** [Ad Kh Qs]
skinchamp: bets 4000
JEC rules: folds 
Uncalled bet (4000) returned to skinchamp
skinchamp collected 5600 from pot
*** SUMMARY ***
Total pot 5600 | Rake 0 
Board [Ad Kh Qs]
Seat 1: mmaatthh folded before Flop (didn't bet)
Seat 2: Taargeett (button) folded before Flop (didn't bet)
Seat 4: skinchamp (small blind) collected (5600)
Seat 5: JEC rules (big blind) folded on the Flop
Seat 6: Cooki2759 folded before Flop (didn't bet)
Seat 7: maicon7k folded before Flop (didn't bet)
Seat 8: ulises23101959 folded before Flop (didn't bet)
Seat 9: KATYBOSS folded before Flop (didn't bet)



PokerStars Hand #201498240109: Tournament #2629783708, 8700+1300 Hold'em No Limit - Level XVI (1250/2500) - 2019/06/17 23:26:35 ET
Table '2629783708 20' 9-max Seat #4 is the button
Seat 1: mmaatthh (2933 in chips) is sitting out
Seat 2: Taargeett (34925 in chips) 
Seat 3: amazing001 (1207 in chips) is sitting out
Seat 4: skinchamp (41306 in chips) 
Seat 5: JEC rules (3005 in chips) 
Seat 6: Cooki2759 (5343 in chips) 
Seat 7: maicon7k (80864 in chips) 
Seat 8: ulises23101959 (28877 in chips) 
Seat 9: KATYBOSS (28458 in chips) is sitting out
mmaatthh: posts the ante 250
Taargeett: posts the ante 250
amazing001: posts the ante 250
skinchamp: posts the ante 250
JEC rules: posts the ante 250
Cooki2759: posts the ante 250
maicon7k: posts the ante 250
ulises23101959: posts the ante 250
KATYBOSS: posts the ante 250
JEC rules: posts small blind 1250
Cooki2759: posts big blind 2500
*** HOLE CARDS ***
Dealt to Taargeett [Qh 2h]
maicon7k: raises 2500 to 5000
ulises23101959: folds 
KATYBOSS: folds 
mmaatthh: folds 
Taargeett: folds 
amazing001: folds 
skinchamp: folds 
JEC rules: calls 1505 and is all-in
Cooki2759: calls 2500
*** FLOP *** [Qc 6d Jd]
Cooki2759: bets 93 and is all-in
maicon7k: calls 93
*** TURN *** [Qc 6d Jd] [8c]
*** RIVER *** [Qc 6d Jd 8c] [3h]
*** SHOW DOWN ***
Cooki2759: shows [7c As] (high card Ace)
maicon7k: shows [6s 6c] (three of a kind, Sixes)
maicon7k collected 4676 from side pot
JEC rules: shows [Qd 9d] (a pair of Queens)
maicon7k collected 10515 from main pot
Cooki2759 finished the tournament in 24th place and received 21500.
JEC rules finished the tournament in 25th place and received 21500.
*** SUMMARY ***
Total pot 15191 Main pot 10515. Side pot 4676. | Rake 0 
Board [Qc 6d Jd 8c 3h]
Seat 1: mmaatthh folded before Flop (didn't bet)
Seat 2: Taargeett folded before Flop (didn't bet)
Seat 3: amazing001 folded before Flop (didn't bet)
Seat 4: skinchamp (button) folded before Flop (didn't bet)
Seat 5: JEC rules (small blind) showed [Qd 9d] and lost with a pair of Queens
Seat 6: Cooki2759 (big blind) showed [7c As] and lost with high card Ace
Seat 7: maicon7k showed [6s 6c] and won (15191) with three of a kind, Sixes
Seat 8: ulises23101959 folded before Flop (didn't bet)
Seat 9: KATYBOSS folded before Flop (didn't bet)



PokerStars Hand #201498245877: Tournament #2629783708, 8700+1300 Hold'em No Limit - Level XVI (1250/2500) - 2019/06/17 23:27:04 ET
Table '2629783708 20' 9-max Seat #7 is the button
Seat 1: mmaatthh (2683 in chips) 
Seat 2: Taargeett (34675 in chips) 
Seat 3: amazing001 (957 in chips) 
Seat 4: skinchamp (41056 in chips) 
Seat 7: maicon7k (90712 in chips) 
Seat 8: ulises23101959 (28627 in chips) 
Seat 9: KATYBOSS (28208 in chips) is sitting out
mmaatthh: posts the ante 250
Taargeett: posts the ante 250
amazing001: posts the ante 250
skinchamp: posts the ante 250
maicon7k: posts the ante 250
ulises23101959: posts the ante 250
KATYBOSS: posts the ante 250
ulises23101959: posts small blind 1250
KATYBOSS: posts big blind 2500
*** HOLE CARDS ***
Dealt to Taargeett [2c Jc]
mmaatthh is disconnected 
mmaatthh is connected 
mmaatthh has timed out
mmaatthh: folds 
Taargeett: folds 
amazing001: calls 707 and is all-in
skinchamp: folds 
maicon7k: folds 
ulises23101959: calls 1250
KATYBOSS: folds 
*** FLOP *** [3d 5c Qs]
*** TURN *** [3d 5c Qs] [7h]
*** RIVER *** [3d 5c Qs 7h] [Td]
*** SHOW DOWN ***
ulises23101959: shows [2s 6s] (high card Queen)
ulises23101959 collected 3586 from side pot
amazing001: shows [9d 9h] (a pair of Nines)
amazing001 collected 3871 from main pot
*** SUMMARY ***
Total pot 7457 Main pot 3871. Side pot 3586. | Rake 0 
Board [3d 5c Qs 7h Td]
Seat 1: mmaatthh folded before Flop (didn't bet)
Seat 2: Taargeett folded before Flop (didn't bet)
Seat 3: amazing001 showed [9d 9h] and won (3871) with a pair of Nines
Seat 4: skinchamp folded before Flop (didn't bet)
Seat 7: maicon7k (button) folded before Flop (didn't bet)
Seat 8: ulises23101959 (small blind) showed [2s 6s] and won (3586) with high card Queen
Seat 9: KATYBOSS (big blind) folded before Flop



PokerStars Hand #201498257298: Tournament #2629783708, 8700+1300 Hold'em No Limit - Level XVI (1250/2500) - 2019/06/17 23:28:01 ET
Table '2629783708 20' 9-max Seat #8 is the button
Seat 1: mmaatthh (2433 in chips) 
Seat 2: Taargeett (34425 in chips) 
Seat 3: amazing001 (3871 in chips) 
Seat 4: skinchamp (40806 in chips) 
Seat 7: maicon7k (90462 in chips) 
Seat 8: ulises23101959 (29463 in chips) 
Seat 9: KATYBOSS (25458 in chips) is sitting out
mmaatthh: posts the ante 250
Taargeett: posts the ante 250
amazing001: posts the ante 250
skinchamp: posts the ante 250
maicon7k: posts the ante 250
ulises23101959: posts the ante 250
KATYBOSS: posts the ante 250
KATYBOSS: posts small blind 1250
mmaatthh: posts big blind 2183 and is all-in
*** HOLE CARDS ***
Dealt to Taargeett [Ts Tc]
Taargeett: raises 2817 to 5000
amazing001 has timed out
amazing001: folds 
skinchamp: folds 
maicon7k: folds 
ulises23101959: calls 5000
KATYBOSS: folds 
*** FLOP *** [7h Th 3h]
Taargeett: checks 
ulises23101959: checks 
*** TURN *** [7h Th 3h] [9s]
Taargeett: bets 2500
ulises23101959: calls 2500
*** RIVER *** [7h Th 3h 9s] [3s]
Taargeett: bets 12500
ulises23101959: folds 
Uncalled bet (12500) returned to Taargeett
*** SHOW DOWN ***
Taargeett: shows [Ts Tc] (a full house, Tens full of Threes)
Taargeett collected 10634 from side pot
mmaatthh: shows [Qc Js] (a pair of Threes)
Taargeett collected 9549 from main pot
mmaatthh finished the tournament in 21st place and received 21500.
*** SUMMARY ***
Total pot 20183 Main pot 9549. Side pot 10634. | Rake 0 
Board [7h Th 3h 9s 3s]
Seat 1: mmaatthh (big blind) showed [Qc Js] and lost with a pair of Threes
Seat 2: Taargeett showed [Ts Tc] and won (20183) with a full house, Tens full of Threes
Seat 3: amazing001 folded before Flop (didn't bet)
Seat 4: skinchamp folded before Flop (didn't bet)
Seat 7: maicon7k folded before Flop (didn't bet)
Seat 8: ulises23101959 (button) folded on the River
Seat 9: KATYBOSS (small blind) folded before Flop



PokerStars Hand #201498273080: Tournament #2629783708, 8700+1300 Hold'em No Limit - Level XVI (1250/2500) - 2019/06/17 23:29:21 ET
Table '2629783708 20' 9-max Seat #9 is the button
Seat 2: Taargeett (46858 in chips) 
Seat 3: amazing001 (3621 in chips) 
Seat 4: skinchamp (40556 in chips) 
Seat 7: maicon7k (90212 in chips) 
Seat 8: ulises23101959 (21713 in chips) 
Seat 9: KATYBOSS (23958 in chips) is sitting out
Taargeett: posts the ante 250
amazing001: posts the ante 250
skinchamp: posts the ante 250
maicon7k: posts the ante 250
ulises23101959: posts the ante 250
KATYBOSS: posts the ante 250
Taargeett: posts small blind 1250
amazing001: posts big blind 2500
*** HOLE CARDS ***
Dealt to Taargeett [Td 2d]
skinchamp: folds 
maicon7k: folds 
ulises23101959: calls 2500
KATYBOSS: folds 
Taargeett: folds 
amazing001 has timed out
amazing001: checks 
*** FLOP *** [9h Kc 4h]
amazing001: checks 
ulises23101959: bets 2500
amazing001: calls 871 and is all-in
Uncalled bet (1629) returned to ulises23101959
*** TURN *** [9h Kc 4h] [Kd]
*** RIVER *** [9h Kc 4h Kd] [6c]
*** SHOW DOWN ***
amazing001: shows [5d 5c] (two pair, Kings and Fives)
ulises23101959: shows [Ad 8d] (a pair of Kings)
amazing001 collected 9492 from pot
*** SUMMARY ***
Total pot 9492 | Rake 0 
Board [9h Kc 4h Kd 6c]
Seat 2: Taargeett (small blind) folded before Flop
Seat 3: amazing001 (big blind) showed [5d 5c] and won (9492) with two pair, Kings and Fives
Seat 4: skinchamp folded before Flop (didn't bet)
Seat 7: maicon7k folded before Flop (didn't bet)
Seat 8: ulises23101959 showed [Ad 8d] and lost with a pair of Kings
Seat 9: KATYBOSS (button) folded before Flop (didn't bet)



PokerStars Hand #201498283439: Tournament #2629783708, 8700+1300 Hold'em No Limit - Level XVI (1250/2500) - 2019/06/17 23:30:14 ET
Table '2629783708 20' 9-max Seat #2 is the button
Seat 2: Taargeett (45358 in chips) 
Seat 3: amazing001 (9492 in chips) 
Seat 4: skinchamp (40306 in chips) 
Seat 7: maicon7k (89962 in chips) 
Seat 8: ulises23101959 (18092 in chips) 
Seat 9: KATYBOSS (23708 in chips) is sitting out
Taargeett: posts the ante 250
amazing001: posts the ante 250
skinchamp: posts the ante 250
maicon7k: posts the ante 250
ulises23101959: posts the ante 250
KATYBOSS: posts the ante 250
amazing001: posts small blind 1250
skinchamp: posts big blind 2500
*** HOLE CARDS ***
Dealt to Taargeett [As Th]
maicon7k: folds 
ulises23101959: folds 
KATYBOSS: folds 
Taargeett: raises 5000 to 7500
amazing001: calls 6250
skinchamp: folds 
*** FLOP *** [8d 5c 2s]
amazing001: bets 1742 and is all-in
Taargeett: calls 1742
*** TURN *** [8d 5c 2s] [Ts]
*** RIVER *** [8d 5c 2s Ts] [8h]
*** SHOW DOWN ***
amazing001: shows [Ah Td] (two pair, Tens and Eights)
Taargeett: shows [As Th] (two pair, Tens and Eights)
amazing001 collected 11242 from pot
Taargeett collected 11242 from pot
*** SUMMARY ***
Total pot 22484 | Rake 0 
Board [8d 5c 2s Ts 8h]
Seat 2: Taargeett (button) showed [As Th] and won (11242) with two pair, Tens and Eights
Seat 3: amazing001 (small blind) showed [Ah Td] and won (11242) with two pair, Tens and Eights
Seat 4: skinchamp (big blind) folded before Flop
Seat 7: maicon7k folded before Flop (didn't bet)
Seat 8: ulises23101959 folded before Flop (didn't bet)
Seat 9: KATYBOSS folded before Flop (didn't bet)



PokerStars Hand #201498291063: Tournament #2629783708, 8700+1300 Hold'em No Limit - Level XVI (1250/2500) - 2019/06/17 23:30:53 ET
Table '2629783708 20' 9-max Seat #3 is the button
Seat 2: Taargeett (47108 in chips) 
Seat 3: amazing001 (11242 in chips) 
Seat 4: skinchamp (37556 in chips) 
Seat 7: maicon7k (89712 in chips) 
Seat 8: ulises23101959 (17842 in chips) 
Seat 9: KATYBOSS (23458 in chips) is sitting out
Taargeett: posts the ante 250
amazing001: posts the ante 250
skinchamp: posts the ante 250
maicon7k: posts the ante 250
ulises23101959: posts the ante 250
KATYBOSS: posts the ante 250
skinchamp: posts small blind 1250
maicon7k: posts big blind 2500
*** HOLE CARDS ***
Dealt to Taargeett [Ac 5h]
amazing001 said, "lucky"
ulises23101959: folds 
KATYBOSS: folds 
Taargeett: folds 
amazing001: folds 
skinchamp: calls 1250
maicon7k: checks 
*** FLOP *** [9c 9d 7h]
skinchamp: checks 
maicon7k: checks 
*** TURN *** [9c 9d 7h] [7c]
skinchamp: bets 2500
maicon7k: folds 
Uncalled bet (2500) returned to skinchamp
skinchamp collected 6500 from pot
*** SUMMARY ***
Total pot 6500 | Rake 0 
Board [9c 9d 7h 7c]
Seat 2: Taargeett folded before Flop (didn't bet)
Seat 3: amazing001 (button) folded before Flop (didn't bet)
Seat 4: skinchamp (small blind) collected (6500)
Seat 7: maicon7k (big blind) folded on the Turn
Seat 8: ulises23101959 folded before Flop (didn't bet)
Seat 9: KATYBOSS folded before Flop (didn't bet)



PokerStars Hand #201498297087: Tournament #2629783708, 8700+1300 Hold'em No Limit - Level XVII (1500/3000) - 2019/06/17 23:31:24 ET
Table '2629783708 20' 9-max Seat #4 is the button
Seat 2: Taargeett (46858 in chips) 
Seat 3: amazing001 (10992 in chips) 
Seat 4: skinchamp (41306 in chips) 
Seat 7: maicon7k (86962 in chips) 
Seat 8: ulises23101959 (17592 in chips) 
Seat 9: KATYBOSS (23208 in chips) is sitting out
Taargeett: posts the ante 300
amazing001: posts the ante 300
skinchamp: posts the ante 300
maicon7k: posts the ante 300
ulises23101959: posts the ante 300
KATYBOSS: posts the ante 300
maicon7k: posts small blind 1500
ulises23101959: posts big blind 3000
*** HOLE CARDS ***
Dealt to Taargeett [8s 5c]
KATYBOSS: folds 
Taargeett: folds 
amazing001 has timed out
amazing001: folds 
skinchamp: folds 
maicon7k: calls 1500
ulises23101959: raises 6000 to 9000
maicon7k: folds 
Uncalled bet (6000) returned to ulises23101959
ulises23101959 collected 7800 from pot
ulises23101959: doesn't show hand 
*** SUMMARY ***
Total pot 7800 | Rake 0 
Seat 2: Taargeett folded before Flop (didn't bet)
Seat 3: amazing001 folded before Flop (didn't bet)
Seat 4: skinchamp (button) folded before Flop (didn't bet)
Seat 7: maicon7k (small blind) folded before Flop
Seat 8: ulises23101959 (big blind) collected (7800)
Seat 9: KATYBOSS folded before Flop (didn't bet)



PokerStars Hand #201498305552: Tournament #2629783708, 8700+1300 Hold'em No Limit - Level XVII (1500/3000) - 2019/06/17 23:32:07 ET
Table '2629783708 20' 9-max Seat #7 is the button
Seat 2: Taargeett (46558 in chips) 
Seat 3: amazing001 (10692 in chips) is sitting out
Seat 4: skinchamp (41006 in chips) 
Seat 7: maicon7k (83662 in chips) 
Seat 8: ulises23101959 (22092 in chips) 
Seat 9: KATYBOSS (22908 in chips) is sitting out
Taargeett: posts the ante 300
amazing001: posts the ante 300
skinchamp: posts the ante 300
maicon7k: posts the ante 300
ulises23101959: posts the ante 300
KATYBOSS: posts the ante 300
ulises23101959: posts small blind 1500
KATYBOSS: posts big blind 3000
*** HOLE CARDS ***
Dealt to Taargeett [4s 2d]
Taargeett: folds 
amazing001: folds 
skinchamp: folds 
maicon7k: folds 
ulises23101959: raises 3000 to 6000
KATYBOSS: calls 3000
*** FLOP *** [Ts 4c Js]
ulises23101959: bets 15792 and is all-in
KATYBOSS: folds 
Uncalled bet (15792) returned to ulises23101959
ulises23101959 collected 13800 from pot
ulises23101959: doesn't show hand 
*** SUMMARY ***
Total pot 13800 | Rake 0 
Board [Ts 4c Js]
Seat 2: Taargeett folded before Flop (didn't bet)
Seat 3: amazing001 folded before Flop (didn't bet)
Seat 4: skinchamp folded before Flop (didn't bet)
Seat 7: maicon7k (button) folded before Flop (didn't bet)
Seat 8: ulises23101959 (small blind) collected (13800)
Seat 9: KATYBOSS (big blind) folded on the Flop



PokerStars Hand #201498314460: Tournament #2629783708, 8700+1300 Hold'em No Limit - Level XVII (1500/3000) - 2019/06/17 23:32:52 ET
Table '2629783708 20' 9-max Seat #8 is the button
Seat 1: jblada (30139 in chips) 
Seat 2: Taargeett (46258 in chips) 
Seat 3: amazing001 (10392 in chips) 
Seat 4: skinchamp (40706 in chips) 
Seat 5: mariabrazdf (93111 in chips) 
Seat 6: TioPac22 (73118 in chips) 
Seat 7: maicon7k (83362 in chips) 
Seat 8: ulises23101959 (29592 in chips) 
Seat 9: KATYBOSS (16608 in chips) 
jblada: posts the ante 300
Taargeett: posts the ante 300
amazing001: posts the ante 300
skinchamp: posts the ante 300
mariabrazdf: posts the ante 300
TioPac22: posts the ante 300
maicon7k: posts the ante 300
ulises23101959: posts the ante 300
KATYBOSS: posts the ante 300
KATYBOSS: posts small blind 1500
jblada: posts big blind 3000
*** HOLE CARDS ***
Dealt to Taargeett [Jh 2s]
Taargeett: folds 
amazing001 has timed out
amazing001: folds 
skinchamp: raises 10200 to 13200
mariabrazdf: calls 13200
TioPac22: folds 
maicon7k: folds 
ulises23101959: folds 
KATYBOSS: folds 
jblada: folds 
*** FLOP *** [7d Ah 3h]
skinchamp: bets 27206 and is all-in
mariabrazdf: calls 27206
*** TURN *** [7d Ah 3h] [8d]
*** RIVER *** [7d Ah 3h 8d] [4c]
*** SHOW DOWN ***
skinchamp: shows [Kc Kh] (a pair of Kings)
mariabrazdf: shows [Ks Qh] (high card Ace)
skinchamp collected 88012 from pot
*** SUMMARY ***
Total pot 88012 | Rake 0 
Board [7d Ah 3h 8d 4c]
Seat 1: jblada (big blind) folded before Flop
Seat 2: Taargeett folded before Flop (didn't bet)
Seat 3: amazing001 folded before Flop (didn't bet)
Seat 4: skinchamp showed [Kc Kh] and won (88012) with a pair of Kings
Seat 5: mariabrazdf showed [Ks Qh] and lost with high card Ace
Seat 6: TioPac22 folded before Flop (didn't bet)
Seat 7: maicon7k folded before Flop (didn't bet)
Seat 8: ulises23101959 (button) folded before Flop (didn't bet)
Seat 9: KATYBOSS (small blind) folded before Flop



PokerStars Hand #201498328615: Tournament #2629783708, 8700+1300 Hold'em No Limit - Level XVII (1500/3000) - 2019/06/17 23:34:03 ET
Table '2629783708 20' 9-max Seat #9 is the button
Seat 1: jblada (26839 in chips) 
Seat 2: Taargeett (45958 in chips) 
Seat 3: amazing001 (10092 in chips) 
Seat 4: skinchamp (88012 in chips) 
Seat 5: mariabrazdf (52405 in chips) 
Seat 6: TioPac22 (72818 in chips) 
Seat 7: maicon7k (83062 in chips) 
Seat 8: ulises23101959 (29292 in chips) 
Seat 9: KATYBOSS (14808 in chips) 
jblada: posts the ante 300
Taargeett: posts the ante 300
amazing001: posts the ante 300
skinchamp: posts the ante 300
mariabrazdf: posts the ante 300
TioPac22: posts the ante 300
maicon7k: posts the ante 300
ulises23101959: posts the ante 300
KATYBOSS: posts the ante 300
jblada: posts small blind 1500
Taargeett: posts big blind 3000
*** HOLE CARDS ***
Dealt to Taargeett [9c As]
amazing001 has timed out
amazing001: folds 
skinchamp: folds 
mariabrazdf: raises 10200 to 13200
TioPac22: folds 
maicon7k: folds 
ulises23101959: folds 
KATYBOSS: raises 1308 to 14508 and is all-in
jblada: folds 
Taargeett: folds 
mariabrazdf: calls 1308
*** FLOP *** [2s Ah 7d]
*** TURN *** [2s Ah 7d] [9h]
*** RIVER *** [2s Ah 7d 9h] [3d]
*** SHOW DOWN ***
mariabrazdf: shows [Tc Kd] (high card Ace)
KATYBOSS: shows [Qh Jd] (high card Ace - lower kicker)
mariabrazdf collected 36216 from pot
KATYBOSS finished the tournament in 18th place and received 30500.
*** SUMMARY ***
Total pot 36216 | Rake 0 
Board [2s Ah 7d 9h 3d]
Seat 1: jblada (small blind) folded before Flop
Seat 2: Taargeett (big blind) folded before Flop
Seat 3: amazing001 folded before Flop (didn't bet)
Seat 4: skinchamp folded before Flop (didn't bet)
Seat 5: mariabrazdf showed [Tc Kd] and won (36216) with high card Ace
Seat 6: TioPac22 folded before Flop (didn't bet)
Seat 7: maicon7k folded before Flop (didn't bet)
Seat 8: ulises23101959 folded before Flop (didn't bet)
Seat 9: KATYBOSS (button) showed [Qh Jd] and lost with high card Ace



PokerStars Hand #201498346373: Tournament #2629783708, 8700+1300 Hold'em No Limit - Level XVII (1500/3000) - 2019/06/17 23:34:49 ET
Table '2629783708 20' 9-max Seat #1 is the button
Seat 1: jblada (25039 in chips) 
Seat 2: Taargeett (42658 in chips) 
Seat 3: amazing001 (9792 in chips) is sitting out
Seat 4: skinchamp (87712 in chips) 
Seat 5: mariabrazdf (73813 in chips) 
Seat 6: TioPac22 (72518 in chips) 
Seat 7: maicon7k (82762 in chips) 
Seat 8: ulises23101959 (28992 in chips) 
jblada: posts the ante 300
Taargeett: posts the ante 300
amazing001: posts the ante 300
skinchamp: posts the ante 300
mariabrazdf: posts the ante 300
TioPac22: posts the ante 300
maicon7k: posts the ante 300
ulises23101959: posts the ante 300
Taargeett: posts small blind 1500
amazing001: posts big blind 3000
*** HOLE CARDS ***
Dealt to Taargeett [Ad Kd]
skinchamp: folds 
mariabrazdf: folds 
TioPac22: calls 3000
maicon7k: folds 
ulises23101959: raises 3000 to 6000
jblada: folds 
Taargeett: raises 3000 to 9000
amazing001 has timed out
amazing001: folds 
TioPac22: calls 6000
ulises23101959: raises 19692 to 28692 and is all-in
Taargeett: raises 13666 to 42358 and is all-in
TioPac22: folds 
Uncalled bet (13666) returned to Taargeett
*** FLOP *** [7d 7h 6h]
*** TURN *** [7d 7h 6h] [9d]
*** RIVER *** [7d 7h 6h 9d] [Jh]
*** SHOW DOWN ***
Taargeett: shows [Ad Kd] (a pair of Sevens)
ulises23101959: shows [Kh Kc] (two pair, Kings and Sevens)
ulises23101959 collected 71784 from pot
*** SUMMARY ***
Total pot 71784 | Rake 0 
Board [7d 7h 6h 9d Jh]
Seat 1: jblada (button) folded before Flop (didn't bet)
Seat 2: Taargeett (small blind) showed [Ad Kd] and lost with a pair of Sevens
Seat 3: amazing001 (big blind) folded before Flop
Seat 4: skinchamp folded before Flop (didn't bet)
Seat 5: mariabrazdf folded before Flop (didn't bet)
Seat 6: TioPac22 folded before Flop
Seat 7: maicon7k folded before Flop (didn't bet)
Seat 8: ulises23101959 showed [Kh Kc] and won (71784) with two pair, Kings and Sevens



PokerStars Hand #201498358910: Tournament #2629783708, 8700+1300 Hold'em No Limit - Level XVII (1500/3000) - 2019/06/17 23:35:53 ET
Table '2629783708 20' 9-max Seat #2 is the button
Seat 1: jblada (24739 in chips) 
Seat 2: Taargeett (13666 in chips) 
Seat 3: amazing001 (6492 in chips) 
Seat 4: skinchamp (87412 in chips) 
Seat 5: mariabrazdf (73513 in chips) 
Seat 6: TioPac22 (63218 in chips) 
Seat 7: maicon7k (82462 in chips) 
Seat 8: ulises23101959 (71784 in chips) 
jblada: posts the ante 300
Taargeett: posts the ante 300
amazing001: posts the ante 300
skinchamp: posts the ante 300
mariabrazdf: posts the ante 300
TioPac22: posts the ante 300
maicon7k: posts the ante 300
ulises23101959: posts the ante 300
amazing001: posts small blind 1500
skinchamp: posts big blind 3000
*** HOLE CARDS ***
Dealt to Taargeett [6d Qc]
mariabrazdf: raises 9900 to 12900
TioPac22: folds 
maicon7k: folds 
ulises23101959: folds 
jblada: folds 
Taargeett: folds 
amazing001 has timed out
amazing001: folds 
skinchamp: folds 
Uncalled bet (9900) returned to mariabrazdf
mariabrazdf collected 9900 from pot
*** SUMMARY ***
Total pot 9900 | Rake 0 
Seat 1: jblada folded before Flop (didn't bet)
Seat 2: Taargeett (button) folded before Flop (didn't bet)
Seat 3: amazing001 (small blind) folded before Flop
Seat 4: skinchamp (big blind) folded before Flop
Seat 5: mariabrazdf collected (9900)
Seat 6: TioPac22 folded before Flop (didn't bet)
Seat 7: maicon7k folded before Flop (didn't bet)
Seat 8: ulises23101959 folded before Flop (didn't bet)



PokerStars Hand #201498366272: Tournament #2629783708, 8700+1300 Hold'em No Limit - Level XVIII (2000/4000) - 2019/06/17 23:36:31 ET
Table '2629783708 20' 9-max Seat #3 is the button
Seat 1: jblada (24439 in chips) 
Seat 2: Taargeett (13366 in chips) 
Seat 3: amazing001 (4692 in chips) is sitting out
Seat 4: skinchamp (84112 in chips) 
Seat 5: mariabrazdf (80113 in chips) 
Seat 6: TioPac22 (62918 in chips) 
Seat 7: maicon7k (82162 in chips) 
Seat 8: ulises23101959 (71484 in chips) 
jblada: posts the ante 400
Taargeett: posts the ante 400
amazing001: posts the ante 400
skinchamp: posts the ante 400
mariabrazdf: posts the ante 400
TioPac22: posts the ante 400
maicon7k: posts the ante 400
ulises23101959: posts the ante 400
skinchamp: posts small blind 2000
mariabrazdf: posts big blind 4000
*** HOLE CARDS ***
Dealt to Taargeett [2c 9c]
TioPac22: folds 
maicon7k: folds 
ulises23101959: folds 
jblada: folds 
Taargeett: folds 
amazing001: folds 
skinchamp: calls 2000
mariabrazdf: checks 
*** FLOP *** [Kc Js 2h]
skinchamp: checks 
mariabrazdf: checks 
*** TURN *** [Kc Js 2h] [8d]
skinchamp: checks 
mariabrazdf: checks 
*** RIVER *** [Kc Js 2h 8d] [Jd]
skinchamp: bets 8000
mariabrazdf: calls 8000
*** SHOW DOWN ***
skinchamp: shows [5h 6h] (a pair of Jacks)
mariabrazdf: shows [6s 6c] (two pair, Jacks and Sixes)
mariabrazdf collected 27200 from pot
*** SUMMARY ***
Total pot 27200 | Rake 0 
Board [Kc Js 2h 8d Jd]
Seat 1: jblada folded before Flop (didn't bet)
Seat 2: Taargeett folded before Flop (didn't bet)
Seat 3: amazing001 (button) folded before Flop (didn't bet)
Seat 4: skinchamp (small blind) showed [5h 6h] and lost with a pair of Jacks
Seat 5: mariabrazdf (big blind) showed [6s 6c] and won (27200) with two pair, Jacks and Sixes
Seat 6: TioPac22 folded before Flop (didn't bet)
Seat 7: maicon7k folded before Flop (didn't bet)
Seat 8: ulises23101959 folded before Flop (didn't bet)



PokerStars Hand #201498373444: Tournament #2629783708, 8700+1300 Hold'em No Limit - Level XVIII (2000/4000) - 2019/06/17 23:37:08 ET
Table '2629783708 20' 9-max Seat #4 is the button
Seat 1: jblada (24039 in chips) 
Seat 2: Taargeett (12966 in chips) 
Seat 3: amazing001 (4292 in chips) 
Seat 4: skinchamp (71712 in chips) 
Seat 5: mariabrazdf (94913 in chips) 
Seat 6: TioPac22 (62518 in chips) 
Seat 7: maicon7k (81762 in chips) 
Seat 8: ulises23101959 (71084 in chips) 
jblada: posts the ante 400
Taargeett: posts the ante 400
amazing001: posts the ante 400
skinchamp: posts the ante 400
mariabrazdf: posts the ante 400
TioPac22: posts the ante 400
maicon7k: posts the ante 400
ulises23101959: posts the ante 400
mariabrazdf: posts small blind 2000
TioPac22: posts big blind 4000
*** HOLE CARDS ***
Dealt to Taargeett [8d 7h]
maicon7k: folds 
ulises23101959: calls 4000
jblada: folds 
Taargeett: folds 
amazing001: calls 3892 and is all-in
skinchamp: folds 
mariabrazdf: calls 2000
TioPac22: checks 
*** FLOP *** [Qs 6s 4s]
mariabrazdf: checks 
TioPac22: checks 
ulises23101959: checks 
*** TURN *** [Qs 6s 4s] [Qc]
mariabrazdf: checks 
TioPac22: checks 
ulises23101959: checks 
*** RIVER *** [Qs 6s 4s Qc] [Kc]
mariabrazdf: checks 
TioPac22: checks 
ulises23101959: checks 
*** SHOW DOWN ***
mariabrazdf: shows [2c 3d] (a pair of Queens)
TioPac22: shows [8c 2d] (a pair of Queens - King+Eight kicker)
ulises23101959: shows [Tc Td] (two pair, Queens and Tens)
ulises23101959 collected 324 from side pot
amazing001: mucks hand 
ulises23101959 collected 18768 from main pot
amazing001 finished the tournament in 14th place and received 39500.
*** SUMMARY ***
Total pot 19092 Main pot 18768. Side pot 324. | Rake 0 
Board [Qs 6s 4s Qc Kc]
Seat 1: jblada folded before Flop (didn't bet)
Seat 2: Taargeett folded before Flop (didn't bet)
Seat 3: amazing001 mucked [4d Ah]
Seat 4: skinchamp (button) folded before Flop (didn't bet)
Seat 5: mariabrazdf (small blind) showed [2c 3d] and lost with a pair of Queens
Seat 6: TioPac22 (big blind) showed [8c 2d] and lost with a pair of Queens
Seat 7: maicon7k folded before Flop (didn't bet)
Seat 8: ulises23101959 showed [Tc Td] and won (19092) with two pair, Queens and Tens



PokerStars Hand #201498382101: Tournament #2629783708, 8700+1300 Hold'em No Limit - Level XVIII (2000/4000) - 2019/06/17 23:37:53 ET
Table '2629783708 20' 9-max Seat #5 is the button
Seat 1: jblada (23639 in chips) 
Seat 2: Taargeett (12566 in chips) 
Seat 4: skinchamp (71312 in chips) 
Seat 5: mariabrazdf (90513 in chips) 
Seat 6: TioPac22 (58118 in chips) 
Seat 7: maicon7k (81362 in chips) 
Seat 8: ulises23101959 (85776 in chips) 
jblada: posts the ante 400
Taargeett: posts the ante 400
skinchamp: posts the ante 400
mariabrazdf: posts the ante 400
TioPac22: posts the ante 400
maicon7k: posts the ante 400
ulises23101959: posts the ante 400
TioPac22: posts small blind 2000
maicon7k: posts big blind 4000
*** HOLE CARDS ***
Dealt to Taargeett [Qs Ah]
ulises23101959: calls 4000
jblada: folds 
Taargeett: raises 8166 to 12166 and is all-in
skinchamp: folds 
mariabrazdf: folds 
TioPac22: calls 10166
maicon7k: folds 
ulises23101959: calls 8166
*** FLOP *** [9c 6c 4h]
TioPac22: checks 
ulises23101959: checks 
*** TURN *** [9c 6c 4h] [4s]
TioPac22: checks 
ulises23101959: checks 
*** RIVER *** [9c 6c 4h 4s] [Jd]
TioPac22: checks 
ulises23101959: checks 
*** SHOW DOWN ***
TioPac22: shows [7s 8c] (a pair of Fours)
ulises23101959: shows [8d Ac] (a pair of Fours - Ace kicker)
Taargeett: shows [Qs Ah] (a pair of Fours - Ace+Queen kicker)
Taargeett collected 43298 from pot
*** SUMMARY ***
Total pot 43298 | Rake 0 
Board [9c 6c 4h 4s Jd]
Seat 1: jblada folded before Flop (didn't bet)
Seat 2: Taargeett showed [Qs Ah] and won (43298) with a pair of Fours
Seat 4: skinchamp folded before Flop (didn't bet)
Seat 5: mariabrazdf (button) folded before Flop (didn't bet)
Seat 6: TioPac22 (small blind) showed [7s 8c] and lost with a pair of Fours
Seat 7: maicon7k (big blind) folded before Flop
Seat 8: ulises23101959 showed [8d Ac] and lost with a pair of Fours



PokerStars Hand #201498388397: Tournament #2629783708, 8700+1300 Hold'em No Limit - Level XVIII (2000/4000) - 2019/06/17 23:38:25 ET
Table '2629783708 20' 9-max Seat #6 is the button
Seat 1: jblada (23239 in chips) 
Seat 2: Taargeett (43298 in chips) 
Seat 4: skinchamp (70912 in chips) 
Seat 5: mariabrazdf (90113 in chips) 
Seat 6: TioPac22 (45552 in chips) 
Seat 7: maicon7k (76962 in chips) 
Seat 8: ulises23101959 (73210 in chips) 
jblada: posts the ante 400
Taargeett: posts the ante 400
skinchamp: posts the ante 400
mariabrazdf: posts the ante 400
TioPac22: posts the ante 400
maicon7k: posts the ante 400
ulises23101959: posts the ante 400
maicon7k: posts small blind 2000
ulises23101959: posts big blind 4000
*** HOLE CARDS ***
Dealt to Taargeett [8s As]
jblada: folds 
Taargeett: raises 4000 to 8000
skinchamp has timed out
skinchamp: folds 
mariabrazdf: folds 
TioPac22: calls 8000
maicon7k: folds 
ulises23101959: calls 4000
*** FLOP *** [8d Qs Th]
ulises23101959: checks 
Taargeett: bets 34898 and is all-in
TioPac22: calls 34898
ulises23101959: folds 
*** TURN *** [8d Qs Th] [3d]
*** RIVER *** [8d Qs Th 3d] [6s]
*** SHOW DOWN ***
Taargeett: shows [8s As] (a pair of Eights)
TioPac22: shows [4c Jc] (high card Queen)
Taargeett collected 98596 from pot
*** SUMMARY ***
Total pot 98596 | Rake 0 
Board [8d Qs Th 3d 6s]
Seat 1: jblada folded before Flop (didn't bet)
Seat 2: Taargeett showed [8s As] and won (98596) with a pair of Eights
Seat 4: skinchamp folded before Flop (didn't bet)
Seat 5: mariabrazdf folded before Flop (didn't bet)
Seat 6: TioPac22 (button) showed [4c Jc] and lost with high card Queen
Seat 7: maicon7k (small blind) folded before Flop
Seat 8: ulises23101959 (big blind) folded on the Flop



PokerStars Hand #201498399769: Tournament #2629783708, 8700+1300 Hold'em No Limit - Level XVIII (2000/4000) - 2019/06/17 23:39:22 ET
Table '2629783708 20' 9-max Seat #7 is the button
Seat 1: jblada (22839 in chips) 
Seat 2: Taargeett (98596 in chips) 
Seat 4: skinchamp (70512 in chips) is sitting out
Seat 5: mariabrazdf (89713 in chips) 
Seat 6: TioPac22 (2254 in chips) 
Seat 7: maicon7k (74562 in chips) 
Seat 8: ulises23101959 (64810 in chips) 
jblada: posts the ante 400
Taargeett: posts the ante 400
skinchamp: posts the ante 400
mariabrazdf: posts the ante 400
TioPac22: posts the ante 400
maicon7k: posts the ante 400
ulises23101959: posts the ante 400
ulises23101959: posts small blind 2000
jblada: posts big blind 4000
*** HOLE CARDS ***
Dealt to Taargeett [3d 3s]
Taargeett: folds 
skinchamp: folds 
mariabrazdf: raises 4000 to 8000
TioPac22: calls 1854 and is all-in
maicon7k: folds 
ulises23101959: calls 6000
jblada: folds 
*** FLOP *** [4s 5d Ts]
ulises23101959: checks 
mariabrazdf: checks 
*** TURN *** [4s 5d Ts] [4c]
ulises23101959: bets 8000
mariabrazdf: folds 
Uncalled bet (8000) returned to ulises23101959
*** RIVER *** [4s 5d Ts 4c] [8d]
*** SHOW DOWN ***
ulises23101959: shows [Kd 9h] (a pair of Fours)
ulises23101959 collected 14438 from side pot
TioPac22: shows [3h Ad] (a pair of Fours - Ace kicker)
TioPac22 collected 10216 from main pot
*** SUMMARY ***
Total pot 24654 Main pot 10216. Side pot 14438. | Rake 0 
Board [4s 5d Ts 4c 8d]
Seat 1: jblada (big blind) folded before Flop
Seat 2: Taargeett folded before Flop (didn't bet)
Seat 4: skinchamp folded before Flop (didn't bet)
Seat 5: mariabrazdf folded on the Turn
Seat 6: TioPac22 showed [3h Ad] and won (10216) with a pair of Fours
Seat 7: maicon7k (button) folded before Flop (didn't bet)
Seat 8: ulises23101959 (small blind) showed [Kd 9h] and won (14438) with a pair of Fours



PokerStars Hand #201498411239: Tournament #2629783708, 8700+1300 Hold'em No Limit - Level XVIII (2000/4000) - 2019/06/17 23:40:21 ET
Table '2629783708 20' 9-max Seat #8 is the button
Seat 1: jblada (18439 in chips) 
Seat 2: Taargeett (98196 in chips) 
Seat 4: skinchamp (70112 in chips) is sitting out
Seat 5: mariabrazdf (81313 in chips) 
Seat 6: TioPac22 (10216 in chips) 
Seat 7: maicon7k (74162 in chips) 
Seat 8: ulises23101959 (70848 in chips) 
jblada: posts the ante 400
Taargeett: posts the ante 400
skinchamp: posts the ante 400
mariabrazdf: posts the ante 400
TioPac22: posts the ante 400
maicon7k: posts the ante 400
ulises23101959: posts the ante 400
jblada: posts small blind 2000
Taargeett: posts big blind 4000
*** HOLE CARDS ***
Dealt to Taargeett [Qs Kh]
skinchamp: folds 
mariabrazdf: folds 
TioPac22: folds 
maicon7k: folds 
ulises23101959: calls 4000
jblada: raises 14039 to 18039 and is all-in
Taargeett: calls 14039
ulises23101959: folds 
*** FLOP *** [2s 4h As]
*** TURN *** [2s 4h As] [7d]
*** RIVER *** [2s 4h As 7d] [9d]
*** SHOW DOWN ***
jblada: shows [6c 6d] (a pair of Sixes)
Taargeett: shows [Qs Kh] (high card Ace)
jblada collected 42878 from pot
*** SUMMARY ***
Total pot 42878 | Rake 0 
Board [2s 4h As 7d 9d]
Seat 1: jblada (small blind) showed [6c 6d] and won (42878) with a pair of Sixes
Seat 2: Taargeett (big blind) showed [Qs Kh] and lost with high card Ace
Seat 4: skinchamp folded before Flop (didn't bet)
Seat 5: mariabrazdf folded before Flop (didn't bet)
Seat 6: TioPac22 folded before Flop (didn't bet)
Seat 7: maicon7k folded before Flop (didn't bet)
Seat 8: ulises23101959 (button) folded before Flop



PokerStars Hand #201498417483: Tournament #2629783708, 8700+1300 Hold'em No Limit - Level XVIII (2000/4000) - 2019/06/17 23:40:53 ET
Table '2629783708 20' 9-max Seat #1 is the button
Seat 1: jblada (42878 in chips) 
Seat 2: Taargeett (79757 in chips) 
Seat 4: skinchamp (69712 in chips) 
Seat 5: mariabrazdf (80913 in chips) 
Seat 6: TioPac22 (9816 in chips) 
Seat 8: ulises23101959 (66448 in chips) 
jblada: posts the ante 400
Taargeett: posts the ante 400
skinchamp: posts the ante 400
mariabrazdf: posts the ante 400
TioPac22: posts the ante 400
ulises23101959: posts the ante 400
Taargeett: posts small blind 2000
skinchamp: posts big blind 4000
*** HOLE CARDS ***
Dealt to Taargeett [9c 7h]
mariabrazdf: calls 4000
TioPac22: raises 5416 to 9416 and is all-in
ulises23101959: folds 
jblada: folds 
Taargeett: folds 
skinchamp: calls 5416
mariabrazdf: calls 5416
*** FLOP *** [Jh Tc Jc]
skinchamp: bets 8000
mariabrazdf: calls 8000
*** TURN *** [Jh Tc Jc] [3d]
skinchamp: checks 
mariabrazdf: checks 
*** RIVER *** [Jh Tc Jc 3d] [3h]
skinchamp: checks 
mariabrazdf: checks 
*** SHOW DOWN ***
skinchamp: shows [4c 7c] (two pair, Jacks and Threes)
mariabrazdf: shows [Ad Kd] (two pair, Jacks and Threes - Ace kicker)
mariabrazdf collected 16000 from side pot
TioPac22: shows [6h Ah] (two pair, Jacks and Threes)
mariabrazdf collected 16324 from main pot
TioPac22 collected 16324 from main pot
*** SUMMARY ***
Total pot 48648 Main pot 32648. Side pot 16000. | Rake 0 
Board [Jh Tc Jc 3d 3h]
Seat 1: jblada (button) folded before Flop (didn't bet)
Seat 2: Taargeett (small blind) folded before Flop
Seat 4: skinchamp (big blind) showed [4c 7c] and lost with two pair, Jacks and Threes
Seat 5: mariabrazdf showed [Ad Kd] and won (32324) with two pair, Jacks and Threes
Seat 6: TioPac22 showed [6h Ah] and won (16324) with two pair, Jacks and Threes
Seat 8: ulises23101959 folded before Flop (didn't bet)



PokerStars Hand #201498427032: Tournament #2629783708, 8700+1300 Hold'em No Limit - Level XIX (2500/5000) - 2019/06/17 23:41:41 ET
Table '2629783708 20' 9-max Seat #2 is the button
Seat 1: jblada (42478 in chips) 
Seat 2: Taargeett (77357 in chips) 
Seat 4: skinchamp (51896 in chips) 
Seat 5: mariabrazdf (95421 in chips) 
Seat 6: TioPac22 (16324 in chips) 
Seat 8: ulises23101959 (66048 in chips) 
jblada: posts the ante 500
Taargeett: posts the ante 500
skinchamp: posts the ante 500
mariabrazdf: posts the ante 500
TioPac22: posts the ante 500
ulises23101959: posts the ante 500
skinchamp: posts small blind 2500
mariabrazdf: posts big blind 5000
*** HOLE CARDS ***
Dealt to Taargeett [7d 4d]
TioPac22: folds 
ulises23101959: calls 5000
jblada: folds 
Taargeett: folds 
skinchamp: calls 2500
mariabrazdf: checks 
*** FLOP *** [Qd 9h 8s]
skinchamp: checks 
mariabrazdf: checks 
ulises23101959: checks 
*** TURN *** [Qd 9h 8s] [Ah]
skinchamp: checks 
mariabrazdf: checks 
ulises23101959: bets 10000
skinchamp: folds 
mariabrazdf: calls 10000
*** RIVER *** [Qd 9h 8s Ah] [Qh]
mariabrazdf: checks 
ulises23101959: checks 
*** SHOW DOWN ***
mariabrazdf: shows [2c 9d] (two pair, Queens and Nines)
ulises23101959: shows [4c Ac] (two pair, Aces and Queens)
ulises23101959 collected 38000 from pot
*** SUMMARY ***
Total pot 38000 | Rake 0 
Board [Qd 9h 8s Ah Qh]
Seat 1: jblada folded before Flop (didn't bet)
Seat 2: Taargeett (button) folded before Flop (didn't bet)
Seat 4: skinchamp (small blind) folded on the Turn
Seat 5: mariabrazdf (big blind) showed [2c 9d] and lost with two pair, Queens and Nines
Seat 6: TioPac22 folded before Flop (didn't bet)
Seat 8: ulises23101959 showed [4c Ac] and won (38000) with two pair, Aces and Queens



PokerStars Hand #201498437221: Tournament #2629783708, 8700+1300 Hold'em No Limit - Level XIX (2500/5000) - 2019/06/17 23:42:33 ET
Table '2629783708 20' 9-max Seat #4 is the button
Seat 1: jblada (41978 in chips) 
Seat 2: Taargeett (76857 in chips) 
Seat 4: skinchamp (46396 in chips) 
Seat 5: mariabrazdf (79921 in chips) 
Seat 6: TioPac22 (15824 in chips) 
Seat 8: ulises23101959 (88548 in chips) 
jblada: posts the ante 500
Taargeett: posts the ante 500
skinchamp: posts the ante 500
mariabrazdf: posts the ante 500
TioPac22: posts the ante 500
ulises23101959: posts the ante 500
mariabrazdf: posts small blind 2500
TioPac22: posts big blind 5000
*** HOLE CARDS ***
Dealt to Taargeett [8c 7d]
ulises23101959: calls 5000
jblada: folds 
Taargeett: folds 
skinchamp: folds 
mariabrazdf: calls 2500
TioPac22: checks 
*** FLOP *** [9c Qd 9d]
mariabrazdf: checks 
TioPac22: checks 
ulises23101959: bets 5000
mariabrazdf: calls 5000
TioPac22: calls 5000
*** TURN *** [9c Qd 9d] [Kc]
mariabrazdf: checks 
TioPac22: checks 
ulises23101959: bets 15000
mariabrazdf: calls 15000
TioPac22: calls 5324 and is all-in
*** RIVER *** [9c Qd 9d Kc] [Qc]
mariabrazdf: checks 
ulises23101959: bets 25000
mariabrazdf: folds 
Uncalled bet (25000) returned to ulises23101959
*** SHOW DOWN ***
ulises23101959: shows [Td Js] (a straight, Nine to King)
ulises23101959 collected 19352 from side pot
TioPac22: shows [Jd 5d] (two pair, Queens and Nines)
ulises23101959 collected 48972 from main pot
TioPac22 finished the tournament in 11th place and received 48400.
*** SUMMARY ***
Total pot 68324 Main pot 48972. Side pot 19352. | Rake 0 
Board [9c Qd 9d Kc Qc]
Seat 1: jblada folded before Flop (didn't bet)
Seat 2: Taargeett folded before Flop (didn't bet)
Seat 4: skinchamp (button) folded before Flop (didn't bet)
Seat 5: mariabrazdf (small blind) folded on the River
Seat 6: TioPac22 (big blind) showed [Jd 5d] and lost with two pair, Queens and Nines
Seat 8: ulises23101959 showed [Td Js] and won (68324) with a straight, Nine to King



PokerStars Hand #201498450292: Tournament #2629783708, 8700+1300 Hold'em No Limit - Level XIX (2500/5000) - 2019/06/17 23:43:39 ET
Table '2629783708 20' 9-max Seat #5 is the button
Seat 1: jblada (41478 in chips) 
Seat 2: Taargeett (76357 in chips) 
Seat 4: skinchamp (45896 in chips) 
Seat 5: mariabrazdf (54421 in chips) 
Seat 8: ulises23101959 (131372 in chips) 
jblada: posts the ante 500
Taargeett: posts the ante 500
skinchamp: posts the ante 500
mariabrazdf: posts the ante 500
ulises23101959: posts the ante 500
ulises23101959: posts small blind 2500
jblada: posts big blind 5000
*** HOLE CARDS ***
Dealt to Taargeett [Qs Ac]
Taargeett: raises 5000 to 10000
skinchamp: folds 
mariabrazdf: calls 10000
ulises23101959 has timed out
ulises23101959: folds 
jblada: calls 5000
*** FLOP *** [5d 2h 3h]
jblada: checks 
Taargeett: bets 15000
mariabrazdf: folds 
jblada: folds 
Uncalled bet (15000) returned to Taargeett
Taargeett collected 35000 from pot
Taargeett: doesn't show hand 
*** SUMMARY ***
Total pot 35000 | Rake 0 
Board [5d 2h 3h]
Seat 1: jblada (big blind) folded on the Flop
Seat 2: Taargeett collected (35000)
Seat 4: skinchamp folded before Flop (didn't bet)
Seat 5: mariabrazdf (button) folded on the Flop
Seat 8: ulises23101959 (small blind) folded before Flop



PokerStars Hand #201498459794: Tournament #2629783708, 8700+1300 Hold'em No Limit - Level XIX (2500/5000) - 2019/06/17 23:44:27 ET
Table '2629783708 20' 9-max Seat #8 is the button
Seat 1: jblada (30978 in chips) 
Seat 2: Taargeett (100857 in chips) 
Seat 4: skinchamp (45396 in chips) 
Seat 5: mariabrazdf (43921 in chips) 
Seat 8: ulises23101959 (128372 in chips) 
jblada: posts the ante 500
Taargeett: posts the ante 500
skinchamp: posts the ante 500
mariabrazdf: posts the ante 500
ulises23101959: posts the ante 500
jblada: posts small blind 2500
Taargeett: posts big blind 5000
*** HOLE CARDS ***
Dealt to Taargeett [Kc 2h]
skinchamp: raises 15000 to 20000
mariabrazdf: raises 23421 to 43421 and is all-in
ulises23101959: folds 
jblada: folds 
Taargeett: folds 
skinchamp: calls 23421
*** FLOP *** [Js Ah 7h]
*** TURN *** [Js Ah 7h] [6c]
*** RIVER *** [Js Ah 7h 6c] [3c]
*** SHOW DOWN ***
skinchamp: shows [6d 6s] (three of a kind, Sixes)
mariabrazdf: shows [9c Ad] (a pair of Aces)
skinchamp collected 96842 from pot
*** SUMMARY ***
Total pot 96842 | Rake 0 
Board [Js Ah 7h 6c 3c]
Seat 1: jblada (small blind) folded before Flop
Seat 2: Taargeett (big blind) folded before Flop
Seat 4: skinchamp showed [6d 6s] and won (96842) with three of a kind, Sixes
Seat 5: mariabrazdf showed [9c Ad] and lost with a pair of Aces
Seat 8: ulises23101959 (button) folded before Flop (didn't bet)



PokerStars Hand #201498467974: Tournament #2629783708, 8700+1300 Hold'em No Limit - Level XIX (2500/5000) - 2019/06/17 23:45:09 ET
Table '2629783708 11' 9-max Seat #2 is the button
Seat 1: maicon7k (71262 in chips) 
Seat 2: D_A_L_O_pues (80362 in chips) 
Seat 3: ulises23101959 (127872 in chips) out of hand (moved from another table into small blind)
Seat 4: skinchamp (98317 in chips) out of hand (moved from another table into small blind)
Seat 5: JLU5946 (132596 in chips) 
Seat 6: jblada (27978 in chips) 
Seat 7: Aprile10 (23711 in chips) 
Seat 8: RIC&DEIA113 (116545 in chips) 
Seat 9: Taargeett (95357 in chips) 
ulises23101959 will be allowed to play after the button
skinchamp will be allowed to play after the button
maicon7k: posts the ante 500
D_A_L_O_pues: posts the ante 500
JLU5946: posts the ante 500
jblada: posts the ante 500
Aprile10: posts the ante 500
RIC&DEIA113: posts the ante 500
Taargeett: posts the ante 500
JLU5946: posts small blind 2500
jblada: posts big blind 5000
*** HOLE CARDS ***
Dealt to Taargeett [6d Ac]
Aprile10: calls 5000
RIC&DEIA113: folds 
Taargeett: folds 
maicon7k: folds 
D_A_L_O_pues: folds 
JLU5946: calls 2500
JLU5946 said, "good luck everyone"
jblada: checks 
*** FLOP *** [4h 3d 9h]
JLU5946: checks 
jblada said, "good luck"
jblada: checks 
Aprile10: checks 
*** TURN *** [4h 3d 9h] [Tc]
JLU5946: checks 
jblada: bets 22478 and is all-in
Aprile10: folds 
JLU5946: folds 
Uncalled bet (22478) returned to jblada
jblada collected 18500 from pot
jblada: doesn't show hand 
*** SUMMARY ***
Total pot 18500 | Rake 0 
Board [4h 3d 9h Tc]
Seat 1: maicon7k folded before Flop (didn't bet)
Seat 2: D_A_L_O_pues (button) folded before Flop (didn't bet)
Seat 5: JLU5946 (small blind) folded on the Turn
Seat 6: jblada (big blind) collected (18500)
Seat 7: Aprile10 folded on the Turn
Seat 8: RIC&DEIA113 folded before Flop (didn't bet)
Seat 9: Taargeett folded before Flop (didn't bet)



PokerStars Hand #201498479692: Tournament #2629783708, 8700+1300 Hold'em No Limit - Level XIX (2500/5000) - 2019/06/17 23:46:09 ET
Table '2629783708 11' 9-max Seat #5 is the button
Seat 1: maicon7k (70762 in chips) 
Seat 2: D_A_L_O_pues (79862 in chips) 
Seat 3: ulises23101959 (127872 in chips) 
Seat 4: skinchamp (98317 in chips) 
Seat 5: JLU5946 (127096 in chips) 
Seat 6: jblada (40978 in chips) 
Seat 7: Aprile10 (18211 in chips) 
Seat 8: RIC&DEIA113 (116045 in chips) 
Seat 9: Taargeett (94857 in chips) 
maicon7k: posts the ante 500
D_A_L_O_pues: posts the ante 500
ulises23101959: posts the ante 500
skinchamp: posts the ante 500
JLU5946: posts the ante 500
jblada: posts the ante 500
Aprile10: posts the ante 500
RIC&DEIA113: posts the ante 500
Taargeett: posts the ante 500
jblada: posts small blind 2500
Aprile10: posts big blind 5000
*** HOLE CARDS ***
Dealt to Taargeett [4h 8s]
RIC&DEIA113: folds 
Taargeett: folds 
maicon7k: folds 
D_A_L_O_pues: folds 
ulises23101959: folds 
skinchamp: raises 5000 to 10000
JLU5946: folds 
jblada: folds 
Aprile10: folds 
Uncalled bet (5000) returned to skinchamp
skinchamp collected 17000 from pot
*** SUMMARY ***
Total pot 17000 | Rake 0 
Seat 1: maicon7k folded before Flop (didn't bet)
Seat 2: D_A_L_O_pues folded before Flop (didn't bet)
Seat 3: ulises23101959 folded before Flop (didn't bet)
Seat 4: skinchamp collected (17000)
Seat 5: JLU5946 (button) folded before Flop (didn't bet)
Seat 6: jblada (small blind) folded before Flop
Seat 7: Aprile10 (big blind) folded before Flop
Seat 8: RIC&DEIA113 folded before Flop (didn't bet)
Seat 9: Taargeett folded before Flop (didn't bet)



PokerStars Hand #201498484036: Tournament #2629783708, 8700+1300 Hold'em No Limit - Level XX (3000/6000) - 2019/06/17 23:46:32 ET
Table '2629783708 11' 9-max Seat #6 is the button
Seat 1: maicon7k (70262 in chips) 
Seat 2: D_A_L_O_pues (79362 in chips) 
Seat 3: ulises23101959 (127372 in chips) 
Seat 4: skinchamp (109817 in chips) 
Seat 5: JLU5946 (126596 in chips) 
Seat 6: jblada (37978 in chips) 
Seat 7: Aprile10 (12711 in chips) 
Seat 8: RIC&DEIA113 (115545 in chips) 
Seat 9: Taargeett (94357 in chips) 
maicon7k: posts the ante 600
D_A_L_O_pues: posts the ante 600
ulises23101959: posts the ante 600
skinchamp: posts the ante 600
JLU5946: posts the ante 600
jblada: posts the ante 600
Aprile10: posts the ante 600
RIC&DEIA113: posts the ante 600
Taargeett: posts the ante 600
Aprile10: posts small blind 3000
RIC&DEIA113: posts big blind 6000
*** HOLE CARDS ***
Dealt to Taargeett [8d Ks]
Taargeett: folds 
maicon7k: raises 6000 to 12000
D_A_L_O_pues: raises 18000 to 30000
ulises23101959: folds 
skinchamp: folds 
JLU5946: folds 
jblada: folds 
Aprile10: folds 
RIC&DEIA113: folds 
maicon7k: calls 18000
*** FLOP *** [8c 2s 7h]
maicon7k: checks 
D_A_L_O_pues: bets 24000
maicon7k: calls 24000
*** TURN *** [8c 2s 7h] [7c]
maicon7k: checks 
D_A_L_O_pues: bets 24762 and is all-in
maicon7k: calls 15662 and is all-in
Uncalled bet (9100) returned to D_A_L_O_pues
*** RIVER *** [8c 2s 7h 7c] [4h]
*** SHOW DOWN ***
maicon7k: shows [Qd Ah] (a pair of Sevens)
D_A_L_O_pues: shows [As Ac] (two pair, Aces and Sevens)
D_A_L_O_pues collected 153724 from pot
maicon7k finished the tournament in 9th place and received 57400.
*** SUMMARY ***
Total pot 153724 | Rake 0 
Board [8c 2s 7h 7c 4h]
Seat 1: maicon7k showed [Qd Ah] and lost with a pair of Sevens
Seat 2: D_A_L_O_pues showed [As Ac] and won (153724) with two pair, Aces and Sevens
Seat 3: ulises23101959 folded before Flop (didn't bet)
Seat 4: skinchamp folded before Flop (didn't bet)
Seat 5: JLU5946 folded before Flop (didn't bet)
Seat 6: jblada (button) folded before Flop (didn't bet)
Seat 7: Aprile10 (small blind) folded before Flop
Seat 8: RIC&DEIA113 (big blind) folded before Flop
Seat 9: Taargeett folded before Flop (didn't bet)



PokerStars Hand #201498495797: Tournament #2629783708, 8700+1300 Hold'em No Limit - Level XX (3000/6000) - 2019/06/17 23:47:33 ET
Table '2629783708 11' 9-max Seat #7 is the button
Seat 2: D_A_L_O_pues (162824 in chips) 
Seat 3: ulises23101959 (126772 in chips) 
Seat 4: skinchamp (109217 in chips) 
Seat 5: JLU5946 (125996 in chips) 
Seat 6: jblada (37378 in chips) 
Seat 7: Aprile10 (9111 in chips) 
Seat 8: RIC&DEIA113 (108945 in chips) 
Seat 9: Taargeett (93757 in chips) 
D_A_L_O_pues: posts the ante 600
ulises23101959: posts the ante 600
skinchamp: posts the ante 600
JLU5946: posts the ante 600
jblada: posts the ante 600
Aprile10: posts the ante 600
RIC&DEIA113: posts the ante 600
Taargeett: posts the ante 600
RIC&DEIA113: posts small blind 3000
Taargeett: posts big blind 6000
*** HOLE CARDS ***
Dealt to Taargeett [Qc 2h]
D_A_L_O_pues: folds 
ulises23101959: calls 6000
skinchamp: folds 
JLU5946: calls 6000
jblada: folds 
Aprile10: raises 2511 to 8511 and is all-in
RIC&DEIA113: calls 5511
Taargeett: folds 
ulises23101959: calls 2511
JLU5946: calls 2511
*** FLOP *** [6c Qs Ad]
RIC&DEIA113: checks 
ulises23101959: checks 
JLU5946: bets 22422
RIC&DEIA113: folds 
ulises23101959: calls 22422
*** TURN *** [6c Qs Ad] [Th]
ulises23101959: checks 
JLU5946: bets 18000
ulises23101959: folds 
Uncalled bet (18000) returned to JLU5946
*** RIVER *** [6c Qs Ad Th] [3s]
*** SHOW DOWN ***
JLU5946: shows [Jh Qd] (a pair of Queens)
JLU5946 collected 44844 from side pot
Aprile10: shows [7s Ks] (high card Ace)
JLU5946 collected 44844 from main pot
Aprile10 finished the tournament in 8th place and received 99200.
*** SUMMARY ***
Total pot 89688 Main pot 44844. Side pot 44844. | Rake 0 
Board [6c Qs Ad Th 3s]
Seat 2: D_A_L_O_pues folded before Flop (didn't bet)
Seat 3: ulises23101959 folded on the Turn
Seat 4: skinchamp folded before Flop (didn't bet)
Seat 5: JLU5946 showed [Jh Qd] and won (89688) with a pair of Queens
Seat 6: jblada folded before Flop (didn't bet)
Seat 7: Aprile10 (button) showed [7s Ks] and lost with high card Ace
Seat 8: RIC&DEIA113 (small blind) folded on the Flop
Seat 9: Taargeett (big blind) folded before Flop



PokerStars Hand #201498510488: Tournament #2629783708, 8700+1300 Hold'em No Limit - Level XX (3000/6000) - 2019/06/17 23:48:48 ET
Table '2629783708 11' 9-max Seat #8 is the button
Seat 2: D_A_L_O_pues (162224 in chips) 
Seat 3: ulises23101959 (95239 in chips) 
Seat 4: skinchamp (108617 in chips) 
Seat 5: JLU5946 (184151 in chips) 
Seat 6: jblada (36778 in chips) 
Seat 8: RIC&DEIA113 (99834 in chips) 
Seat 9: Taargeett (87157 in chips) 
D_A_L_O_pues: posts the ante 600
ulises23101959: posts the ante 600
skinchamp: posts the ante 600
JLU5946: posts the ante 600
jblada: posts the ante 600
RIC&DEIA113: posts the ante 600
Taargeett: posts the ante 600
Taargeett: posts small blind 3000
D_A_L_O_pues: posts big blind 6000
*** HOLE CARDS ***
Dealt to Taargeett [Tc Qd]
ulises23101959: folds 
skinchamp: raises 6000 to 12000
JLU5946: calls 12000
jblada: folds 
RIC&DEIA113: folds 
Taargeett: folds 
D_A_L_O_pues: folds 
*** FLOP *** [4c 6s Kh]
skinchamp: checks 
JLU5946: checks 
*** TURN *** [4c 6s Kh] [3c]
skinchamp: checks 
JLU5946: checks 
*** RIVER *** [4c 6s Kh 3c] [8h]
skinchamp: checks 
JLU5946: bets 18600
skinchamp: folds 
Uncalled bet (18600) returned to JLU5946
JLU5946 collected 37200 from pot
JLU5946: doesn't show hand 
*** SUMMARY ***
Total pot 37200 | Rake 0 
Board [4c 6s Kh 3c 8h]
Seat 2: D_A_L_O_pues (big blind) folded before Flop
Seat 3: ulises23101959 folded before Flop (didn't bet)
Seat 4: skinchamp folded on the River
Seat 5: JLU5946 collected (37200)
Seat 6: jblada folded before Flop (didn't bet)
Seat 8: RIC&DEIA113 (button) folded before Flop (didn't bet)
Seat 9: Taargeett (small blind) folded before Flop



PokerStars Hand #201498517666: Tournament #2629783708, 8700+1300 Hold'em No Limit - Level XX (3000/6000) - 2019/06/17 23:49:26 ET
Table '2629783708 11' 9-max Seat #9 is the button
Seat 2: D_A_L_O_pues (155624 in chips) 
Seat 3: ulises23101959 (94639 in chips) 
Seat 4: skinchamp (96017 in chips) 
Seat 5: JLU5946 (208751 in chips) 
Seat 6: jblada (36178 in chips) 
Seat 8: RIC&DEIA113 (99234 in chips) 
Seat 9: Taargeett (83557 in chips) 
D_A_L_O_pues: posts the ante 600
ulises23101959: posts the ante 600
skinchamp: posts the ante 600
JLU5946: posts the ante 600
jblada: posts the ante 600
RIC&DEIA113: posts the ante 600
Taargeett: posts the ante 600
D_A_L_O_pues: posts small blind 3000
ulises23101959: posts big blind 6000
*** HOLE CARDS ***
Dealt to Taargeett [Qh As]
skinchamp: folds 
JLU5946: calls 6000
jblada: raises 29578 to 35578 and is all-in
RIC&DEIA113: calls 35578
Taargeett: calls 35578
D_A_L_O_pues: folds 
ulises23101959: folds 
JLU5946: folds 
*** FLOP *** [9c 4h 7d]
RIC&DEIA113: checks 
Taargeett: bets 18000
RIC&DEIA113: folds 
Uncalled bet (18000) returned to Taargeett
*** TURN *** [9c 4h 7d] [Ts]
*** RIVER *** [9c 4h 7d Ts] [7c]
*** SHOW DOWN ***
jblada: shows [Ah 9h] (two pair, Nines and Sevens)
Taargeett: shows [Qh As] (a pair of Sevens)
jblada collected 125934 from pot
*** SUMMARY ***
Total pot 125934 | Rake 0 
Board [9c 4h 7d Ts 7c]
Seat 2: D_A_L_O_pues (small blind) folded before Flop
Seat 3: ulises23101959 (big blind) folded before Flop
Seat 4: skinchamp folded before Flop (didn't bet)
Seat 5: JLU5946 folded before Flop
Seat 6: jblada showed [Ah 9h] and won (125934) with two pair, Nines and Sevens
Seat 8: RIC&DEIA113 folded on the Flop
Seat 9: Taargeett (button) showed [Qh As] and lost with a pair of Sevens



PokerStars Hand #201498526512: Tournament #2629783708, 8700+1300 Hold'em No Limit - Level XX (3000/6000) - 2019/06/17 23:50:13 ET
Table '2629783708 11' 9-max Seat #2 is the button
Seat 2: D_A_L_O_pues (152024 in chips) 
Seat 3: ulises23101959 (88039 in chips) 
Seat 4: skinchamp (95417 in chips) 
Seat 5: JLU5946 (202151 in chips) 
Seat 6: jblada (125934 in chips) 
Seat 8: RIC&DEIA113 (63056 in chips) 
Seat 9: Taargeett (47379 in chips) 
D_A_L_O_pues: posts the ante 600
ulises23101959: posts the ante 600
skinchamp: posts the ante 600
JLU5946: posts the ante 600
jblada: posts the ante 600
RIC&DEIA113: posts the ante 600
Taargeett: posts the ante 600
ulises23101959: posts small blind 3000
skinchamp: posts big blind 6000
*** HOLE CARDS ***
Dealt to Taargeett [4h 7d]
JLU5946: raises 12000 to 18000
jblada: folds 
RIC&DEIA113: calls 18000
Taargeett: folds 
D_A_L_O_pues: folds 
ulises23101959: folds 
skinchamp: calls 12000
*** FLOP *** [6d 7s 2h]
skinchamp: checks 
JLU5946: checks 
RIC&DEIA113: bets 44456 and is all-in
skinchamp: raises 32361 to 76817 and is all-in
JLU5946: calls 76817
*** TURN *** [6d 7s 2h] [Ts]
*** RIVER *** [6d 7s 2h Ts] [Kd]
*** SHOW DOWN ***
skinchamp: shows [6h 5h] (a pair of Sixes)
JLU5946: shows [7c 7h] (three of a kind, Sevens)
JLU5946 collected 64722 from side pot
RIC&DEIA113: shows [Ks Th] (two pair, Kings and Tens)
JLU5946 collected 194568 from main pot
skinchamp finished the tournament in 6th place and received 186300.
RIC&DEIA113 finished the tournament in 7th place and received 141400.
*** SUMMARY ***
Total pot 259290 Main pot 194568. Side pot 64722. | Rake 0 
Board [6d 7s 2h Ts Kd]
Seat 2: D_A_L_O_pues (button) folded before Flop (didn't bet)
Seat 3: ulises23101959 (small blind) folded before Flop
Seat 4: skinchamp (big blind) showed [6h 5h] and lost with a pair of Sixes
Seat 5: JLU5946 showed [7c 7h] and won (259290) with three of a kind, Sevens
Seat 6: jblada folded before Flop (didn't bet)
Seat 8: RIC&DEIA113 showed [Ks Th] and lost with two pair, Kings and Tens
Seat 9: Taargeett folded before Flop (didn't bet)



PokerStars Hand #201498534499: Tournament #2629783708, 8700+1300 Hold'em No Limit - Level XX (3000/6000) - 2019/06/17 23:50:55 ET
Table '2629783708 11' 9-max Seat #3 is the button
Seat 2: D_A_L_O_pues (151424 in chips) 
Seat 3: ulises23101959 (84439 in chips) 
Seat 5: JLU5946 (366024 in chips) 
Seat 6: jblada (125334 in chips) 
Seat 9: Taargeett (46779 in chips) 
D_A_L_O_pues: posts the ante 600
ulises23101959: posts the ante 600
JLU5946: posts the ante 600
jblada: posts the ante 600
Taargeett: posts the ante 600
JLU5946: posts small blind 3000
jblada: posts big blind 6000
*** HOLE CARDS ***
Dealt to Taargeett [2s 2h]
Taargeett: folds 
D_A_L_O_pues: calls 6000
ulises23101959: folds 
JLU5946: calls 3000
jblada: checks 
*** FLOP *** [Js 3h Jh]
JLU5946: checks 
jblada: checks 
D_A_L_O_pues: bets 18000
JLU5946: folds 
jblada: folds 
Uncalled bet (18000) returned to D_A_L_O_pues
D_A_L_O_pues collected 21000 from pot
D_A_L_O_pues: doesn't show hand 
*** SUMMARY ***
Total pot 21000 | Rake 0 
Board [Js 3h Jh]
Seat 2: D_A_L_O_pues collected (21000)
Seat 3: ulises23101959 (button) folded before Flop (didn't bet)
Seat 5: JLU5946 (small blind) folded on the Flop
Seat 6: jblada (big blind) folded on the Flop
Seat 9: Taargeett folded before Flop (didn't bet)



PokerStars Hand #201498543381: Tournament #2629783708, 8700+1300 Hold'em No Limit - Level XXI (3500/7000) - 2019/06/17 23:51:42 ET
Table '2629783708 11' 9-max Seat #5 is the button
Seat 2: D_A_L_O_pues (165824 in chips) 
Seat 3: ulises23101959 (83839 in chips) 
Seat 5: JLU5946 (359424 in chips) 
Seat 6: jblada (118734 in chips) 
Seat 9: Taargeett (46179 in chips) 
D_A_L_O_pues: posts the ante 700
ulises23101959: posts the ante 700
JLU5946: posts the ante 700
jblada: posts the ante 700
Taargeett: posts the ante 700
jblada: posts small blind 3500
Taargeett: posts big blind 7000
*** HOLE CARDS ***
Dealt to Taargeett [Th 2d]
D_A_L_O_pues: folds 
ulises23101959: calls 7000
JLU5946: calls 7000
jblada: calls 3500
Taargeett: checks 
*** FLOP *** [2h 4d Jd]
jblada: checks 
Taargeett: bets 38479 and is all-in
ulises23101959: folds 
JLU5946: folds 
jblada: folds 
Uncalled bet (38479) returned to Taargeett
Taargeett collected 31500 from pot
Taargeett: doesn't show hand 
*** SUMMARY ***
Total pot 31500 | Rake 0 
Board [2h 4d Jd]
Seat 2: D_A_L_O_pues folded before Flop (didn't bet)
Seat 3: ulises23101959 folded on the Flop
Seat 5: JLU5946 (button) folded on the Flop
Seat 6: jblada (small blind) folded on the Flop
Seat 9: Taargeett (big blind) collected (31500)



PokerStars Hand #201498551344: Tournament #2629783708, 8700+1300 Hold'em No Limit - Level XXI (3500/7000) - 2019/06/17 23:52:24 ET
Table '2629783708 11' 9-max Seat #6 is the button
Seat 2: D_A_L_O_pues (165124 in chips) 
Seat 3: ulises23101959 (76139 in chips) 
Seat 5: JLU5946 (351724 in chips) 
Seat 6: jblada (111034 in chips) 
Seat 9: Taargeett (69979 in chips) 
D_A_L_O_pues: posts the ante 700
ulises23101959: posts the ante 700
JLU5946: posts the ante 700
jblada: posts the ante 700
Taargeett: posts the ante 700
Taargeett: posts small blind 3500
D_A_L_O_pues: posts big blind 7000
*** HOLE CARDS ***
Dealt to Taargeett [9d 4d]
ulises23101959: folds 
JLU5946: calls 7000
jblada: raises 14000 to 21000
Taargeett: folds 
D_A_L_O_pues: folds 
JLU5946: calls 14000
*** FLOP *** [6h As Ad]
JLU5946: checks 
jblada: bets 21000
JLU5946: calls 21000
*** TURN *** [6h As Ad] [4h]
JLU5946: checks 
jblada: bets 21000
JLU5946: calls 21000
*** RIVER *** [6h As Ad 4h] [Qh]
JLU5946: checks 
jblada: bets 47334 and is all-in
JLU5946: calls 47334
*** SHOW DOWN ***
jblada: shows [Th Td] (two pair, Aces and Tens)
JLU5946: shows [6c Ac] (a full house, Aces full of Sixes)
JLU5946 collected 234668 from pot
jblada finished the tournament in 5th place and received 231100.
*** SUMMARY ***
Total pot 234668 | Rake 0 
Board [6h As Ad 4h Qh]
Seat 2: D_A_L_O_pues (big blind) folded before Flop
Seat 3: ulises23101959 folded before Flop (didn't bet)
Seat 5: JLU5946 showed [6c Ac] and won (234668) with a full house, Aces full of Sixes
Seat 6: jblada (button) showed [Th Td] and lost with two pair, Aces and Tens
Seat 9: Taargeett (small blind) folded before Flop



PokerStars Hand #201498564949: Tournament #2629783708, 8700+1300 Hold'em No Limit - Level XXI (3500/7000) - 2019/06/17 23:53:37 ET
Table '2629783708 11' 9-max Seat #9 is the button
Seat 2: D_A_L_O_pues (157424 in chips) 
Seat 3: ulises23101959 (75439 in chips) 
Seat 5: JLU5946 (475358 in chips) 
Seat 9: Taargeett (65779 in chips) 
D_A_L_O_pues: posts the ante 700
ulises23101959: posts the ante 700
JLU5946: posts the ante 700
Taargeett: posts the ante 700
D_A_L_O_pues: posts small blind 3500
ulises23101959: posts big blind 7000
*** HOLE CARDS ***
Dealt to Taargeett [2h Ts]
JLU5946: calls 7000
Taargeett: folds 
D_A_L_O_pues: calls 3500
ulises23101959: raises 67739 to 74739 and is all-in
JLU5946: folds 
D_A_L_O_pues: folds 
Uncalled bet (67739) returned to ulises23101959
ulises23101959 collected 23800 from pot
ulises23101959: doesn't show hand 
*** SUMMARY ***
Total pot 23800 | Rake 0 
Seat 2: D_A_L_O_pues (small blind) folded before Flop
Seat 3: ulises23101959 (big blind) collected (23800)
Seat 5: JLU5946 folded before Flop
Seat 9: Taargeett (button) folded before Flop (didn't bet)



PokerStars Hand #201498571699: Tournament #2629783708, 8700+1300 Hold'em No Limit - Level XXI (3500/7000) - 2019/06/17 23:54:13 ET
Table '2629783708 11' 9-max Seat #2 is the button
Seat 2: D_A_L_O_pues (149724 in chips) 
Seat 3: ulises23101959 (91539 in chips) 
Seat 5: JLU5946 (467658 in chips) 
Seat 9: Taargeett (65079 in chips) 
D_A_L_O_pues: posts the ante 700
ulises23101959: posts the ante 700
JLU5946: posts the ante 700
Taargeett: posts the ante 700
ulises23101959: posts small blind 3500
JLU5946: posts big blind 7000
*** HOLE CARDS ***
Dealt to Taargeett [8c 2h]
Taargeett: folds 
D_A_L_O_pues: calls 7000
ulises23101959: calls 3500
JLU5946: checks 
*** FLOP *** [Jh 8s Ts]
ulises23101959: checks 
JLU5946: checks 
D_A_L_O_pues: checks 
*** TURN *** [Jh 8s Ts] [Qc]
ulises23101959: bets 14000
JLU5946: raises 14000 to 28000
D_A_L_O_pues: folds 
ulises23101959: folds 
Uncalled bet (14000) returned to JLU5946
JLU5946 collected 51800 from pot
JLU5946: doesn't show hand 
*** SUMMARY ***
Total pot 51800 | Rake 0 
Board [Jh 8s Ts Qc]
Seat 2: D_A_L_O_pues (button) folded on the Turn
Seat 3: ulises23101959 (small blind) folded on the Turn
Seat 5: JLU5946 (big blind) collected (51800)
Seat 9: Taargeett folded before Flop (didn't bet)



PokerStars Hand #201498579065: Tournament #2629783708, 8700+1300 Hold'em No Limit - Level XXI (3500/7000) - 2019/06/17 23:54:52 ET
Table '2629783708 11' 9-max Seat #3 is the button
Seat 2: D_A_L_O_pues (142024 in chips) 
Seat 3: ulises23101959 (69839 in chips) 
Seat 5: JLU5946 (497758 in chips) 
Seat 9: Taargeett (64379 in chips) 
D_A_L_O_pues: posts the ante 700
ulises23101959: posts the ante 700
JLU5946: posts the ante 700
Taargeett: posts the ante 700
JLU5946: posts small blind 3500
Taargeett: posts big blind 7000
*** HOLE CARDS ***
Dealt to Taargeett [Qs 2d]
D_A_L_O_pues: calls 7000
ulises23101959: calls 7000
JLU5946: calls 3500
Taargeett: checks 
*** FLOP *** [4c 2s Ac]
JLU5946: checks 
Taargeett: checks 
D_A_L_O_pues: checks 
ulises23101959: bets 14000
JLU5946: calls 14000
Taargeett: folds 
D_A_L_O_pues: folds 
*** TURN *** [4c 2s Ac] [5d]
JLU5946: checks 
ulises23101959: bets 48139 and is all-in
JLU5946: calls 48139
*** RIVER *** [4c 2s Ac 5d] [Ad]
*** SHOW DOWN ***
JLU5946: shows [As 6c] (three of a kind, Aces)
ulises23101959: shows [5h 3h] (a straight, Ace to Five)
ulises23101959 collected 155078 from pot
*** SUMMARY ***
Total pot 155078 | Rake 0 
Board [4c 2s Ac 5d Ad]
Seat 2: D_A_L_O_pues folded on the Flop
Seat 3: ulises23101959 (button) showed [5h 3h] and won (155078) with a straight, Ace to Five
Seat 5: JLU5946 (small blind) showed [As 6c] and lost with three of a kind, Aces
Seat 9: Taargeett (big blind) folded on the Flop



PokerStars Hand #201498636729: Tournament #2629783708, 8700+1300 Hold'em No Limit - Level XXI (3500/7000) - 2019/06/18 0:00:38 ET
Table '2629783708 11' 9-max Seat #5 is the button
Seat 2: D_A_L_O_pues (134324 in chips) 
Seat 3: ulises23101959 (155078 in chips) 
Seat 5: JLU5946 (427919 in chips) 
Seat 9: Taargeett (56679 in chips) 
D_A_L_O_pues: posts the ante 700
ulises23101959: posts the ante 700
JLU5946: posts the ante 700
Taargeett: posts the ante 700
Taargeett: posts small blind 3500
D_A_L_O_pues: posts big blind 7000
*** HOLE CARDS ***
Dealt to Taargeett [Kd 3h]
ulises23101959: folds 
JLU5946: calls 7000
Taargeett: raises 48979 to 55979 and is all-in
D_A_L_O_pues has timed out
D_A_L_O_pues: folds 
JLU5946: calls 48979
*** FLOP *** [3c 7c Jh]
*** TURN *** [3c 7c Jh] [7h]
*** RIVER *** [3c 7c Jh 7h] [Ks]
*** SHOW DOWN ***
Taargeett: shows [Kd 3h] (two pair, Kings and Sevens)
JLU5946: shows [8s Ah] (a pair of Sevens)
Taargeett collected 121758 from pot
*** SUMMARY ***
Total pot 121758 | Rake 0 
Board [3c 7c Jh 7h Ks]
Seat 2: D_A_L_O_pues (big blind) folded before Flop
Seat 3: ulises23101959 folded before Flop (didn't bet)
Seat 5: JLU5946 (button) showed [8s Ah] and lost with a pair of Sevens
Seat 9: Taargeett (small blind) showed [Kd 3h] and won (121758) with two pair, Kings and Sevens



PokerStars Hand #201498644057: Tournament #2629783708, 8700+1300 Hold'em No Limit - Level XXI (3500/7000) - 2019/06/18 0:01:19 ET
Table '2629783708 11' 9-max Seat #9 is the button
Seat 2: D_A_L_O_pues (126624 in chips) is sitting out
Seat 3: ulises23101959 (154378 in chips) 
Seat 5: JLU5946 (371240 in chips) 
Seat 9: Taargeett (121758 in chips) 
D_A_L_O_pues: posts the ante 700
ulises23101959: posts the ante 700
JLU5946: posts the ante 700
Taargeett: posts the ante 700
D_A_L_O_pues: posts small blind 3500
ulises23101959: posts big blind 7000
*** HOLE CARDS ***
Dealt to Taargeett [2c Qh]
JLU5946 said, "nh"
JLU5946: calls 7000
Taargeett: folds 
D_A_L_O_pues: folds 
ulises23101959: raises 7000 to 14000
JLU5946: calls 7000
*** FLOP *** [7s Jd 7d]
ulises23101959: bets 7000
JLU5946: calls 7000
*** TURN *** [7s Jd 7d] [Qc]
ulises23101959: bets 7000
JLU5946: calls 7000
*** RIVER *** [7s Jd 7d Qc] [Js]
ulises23101959: bets 14000
JLU5946: raises 14000 to 28000
ulises23101959: folds 
Uncalled bet (14000) returned to JLU5946
JLU5946 collected 90300 from pot
JLU5946: doesn't show hand 
*** SUMMARY ***
Total pot 90300 | Rake 0 
Board [7s Jd 7d Qc Js]
Seat 2: D_A_L_O_pues (small blind) folded before Flop
Seat 3: ulises23101959 (big blind) folded on the River
Seat 5: JLU5946 collected (90300)
Seat 9: Taargeett (button) folded before Flop (didn't bet)



PokerStars Hand #201498654212: Tournament #2629783708, 8700+1300 Hold'em No Limit - Level XXII (4000/8000) - 2019/06/18 0:02:14 ET
Table '2629783708 11' 9-max Seat #2 is the button
Seat 2: D_A_L_O_pues (122424 in chips) 
Seat 3: ulises23101959 (111678 in chips) 
Seat 5: JLU5946 (418840 in chips) 
Seat 9: Taargeett (121058 in chips) 
D_A_L_O_pues: posts the ante 800
ulises23101959: posts the ante 800
JLU5946: posts the ante 800
Taargeett: posts the ante 800
ulises23101959: posts small blind 4000
JLU5946: posts big blind 8000
*** HOLE CARDS ***
Dealt to Taargeett [Kh 4s]
Taargeett: raises 112258 to 120258 and is all-in
D_A_L_O_pues: folds 
ulises23101959: folds 
JLU5946: calls 112258
*** FLOP *** [7h Jc Jd]
*** TURN *** [7h Jc Jd] [5h]
*** RIVER *** [7h Jc Jd 5h] [7d]
*** SHOW DOWN ***
JLU5946: shows [9c Ac] (two pair, Jacks and Sevens)
Taargeett: shows [Kh 4s] (two pair, Jacks and Sevens - lower kicker)
JLU5946 collected 247716 from pot
Taargeett finished the tournament in 4th place and received 327700.
*** SUMMARY ***
Total pot 247716 | Rake 0 
Board [7h Jc Jd 5h 7d]
Seat 2: D_A_L_O_pues (button) folded before Flop (didn't bet)
Seat 3: ulises23101959 (small blind) folded before Flop
Seat 5: JLU5946 (big blind) showed [9c Ac] and won (247716) with two pair, Jacks and Sevens
Seat 9: Taargeett showed [Kh 4s] and lost with two pair, Jacks and Sevens



